的	e
一	f
了	v
是	j
不	d
我	q
在	s
人	t
有	sw
这	p
他	ec
来	fp
个	tn
你	ey
说	ou
上	k
到	h
就	om
着	u
大	g
们	ep
道	ut
那	va
么	qv
也	cy
地	hc
子	vk
下	ak
出	x
时	ja
看	tm
要	dc
她	cc
中	l
没	i
然	w
里	kk
为	o
过	ap
自	tk
好	c
得	r
去	hv
可	a
会	ts
天	fg
还	dp
心	y
后	ef
以	xo
小	m
都	hj
和	rl
对	b
想	fm
能	vw
起	db
之	pe
手	tu
而	sr
只	lt
生	wg
什	edi
身	wm
头	sg
样	fu
事	al
多	rr
己	bj
家	od
面	gi
知	ql
开	fs
如	cl
无	fd
现	gk
很	rv
点	ml
前	uw
发	xb
经	vb
情	yh
把	ac
老	hr
些	nr
话	or
已	bi
又	bu
声	hb
意	ij
于	fa
回	n
笑	qe
所	ie
但	ej
眼	mv
成	dv
方	og
年	qa
见	kx
当	mx
女	cn
真	dm
两	fk
力	xk
气	qq
从	tt
长	th
动	sv
间	pj
国	ng
走	dk
让	ok
被	pv
给	vy
正	fn
问	pl
打	aa
明	jw
儿	qr
法	ih
才	aq
几	qj
行	ra
定	of
此	nri
进	st
再	gkf
种	rln
将	ur
实	os
同	kf
最	jab
本	ff
向	rn
分	tb
十	di
学	iy
高	ol
第	qvn
感	df
怎	qm
神	hk
听	le
边	xp
作	eq
其	dj
吧	lc
口	lv
觉	iyk
啊	lca
因	ngd
次	se
军	yhc
做	ed
外	rm
门	pn
光	mh
风	qw
主	ogn
住	eo
果	jfv
与	sf
全	tg
二	si
候	en
公	tv
相	fmf
吗	lx
等	qh
别	lxm
色	yc
死	fr
张	vt
部	il
太	go
日	jr
少	mq
战	mlg
理	gkk
直	dmi
重	wk
王	gn
像	eyl
脸	wt
比	rri
快	yb
何	ea
水	kv
名	rlv
体	eff
呢	lb
东	am
叫	lxg
西	dx
应	ui
便	efj
放	oe
马	xm
难	bw
轻	hbf
更	fj
美	ug
位	ei
关	ugd
机	fq
接	ai
先	wq
文	pw
处	em
并	us
望	uwg
常	nm
完	ofh
四	nq
飞	vs
师	uf
者	hjr
安	oc
清	ihw
刚	kw
跟	nv
月	wy
信	eu
山	js
爱	eys
内	kt
龙	dq
空	pf
带	sy
找	ag
原	sem
入	ru
李	fv
连	hp
吃	lq
场	hvt
平	hu
思	jy
林	ffv
变	pb
使	efl
由	ko
受	eyb
亲	if
命	yx
目	mf
强	vl
男	jx
任	ee
该	oo
路	nel
今	to
海	iqb
加	xl
远	fh
活	ir
特	wh
解	yt
电	kd
世	hi
性	yw
表	hry
许	oq
它	ori
立	id
黑	ne
金	wj
红	vf
花	ser
转	hs
总	ul
算	qms
城	hd
队	ct
孩	vo
反	eb
工	fo
始	cv
满	is
新	ife
兵	eft
物	ww
离	px
非	li
虽	lkc
云	svv
似	ex
万	fw
干	hg
通	bt
认	ot
失	qg
火	uo
哥	ala
士	hf
五	fc
惊	yo
魔	pwu
竟	ijq
姐	cm
乎	qu
剑	tfi
往	ro
量	jf
早	jd
结	vh
怕	yeb
流	io
突	ps
坐	tth
斯	de
音	ijr
紧	nb
指	ar
拉	aid
杀	wf
半	ua
记	ob
且	mi
利	rmd
合	ye
倒	eh
书	vv
度	usf
微	rf
步	nma
教	hve
喜	hl
越	dg
影	jo
谁	ow
冷	sto
深	iyt
告	wl
象	yld
容	pt
怪	ybh
传	es
钱	tf
提	aj
随	cs
每	qb
双	bb
服	wx
击	ax
哪	lva
数	pc
站	im
奇	ga
房	iog
管	qo
灵	xu
刻	omd
题	jfn
衣	ory
周	whl
静	hw
伤	eqx
百	djr
拿	ytu
妈	cx
办	xt
星	jwg
化	er
功	fx
绝	vyc
系	qbs
般	qqh
必	yq
业	kg
尔	ym
件	ew
血	qmn
代	eg
精	ph
弟	uv
终	ve
近	epd
条	efv
青	hwy
界	jt
司	vfl
整	fl
欢	be
字	ov
晚	jyl
民	ca
帮	dcm
切	ab
即	xv
忙	yu
交	otw
或	gl
暗	ji
夫	gu
员	lk
根	fvn
石	dh
哈	ly
夜	oer
父	tw
制	wkm
友	sb
阿	cal
息	ty
冲	sl
酒	ig
保	el
片	tp
形	fst
阵	ch
南	dku
决	sbt
请	oh
各	elv
报	axb
兴	it
阳	cj
急	yxy
语	ofc
令	tob
错	tsj
及	vod
刘	pmd
极	fvo
识	olt
备	ejt
慢	yj
雪	dxl
苦	sd
若	ss
收	xe
底	uta
尽	bo
准	swi
华	erd
答	qy
众	ttt
消	imw
视	hkx
罗	mr
敢	vae
留	tj
克	dqr
乐	tma
够	wlr
跑	nw
显	jk
嘴	ln
断	pxe
未	he
势	ay
句	wlv
计	odi
论	otr
达	gp
则	km
害	odl
八	ti
单	uj
久	yod
脚	whv
德	rd
元	fhw
脑	wp
雨	dy
睛	mhw
响	lr
刀	bd
确	dyt
玉	god
沉	iyq
北	uri
格	fe
停	eoa
陈	cam
市	omv
朝	djw
喝	lj
族	oqq
江	ifo
团	na
母	bm
章	ijd
装	uh
亮	oqj
客	oel
照	jb
乱	rx
易	jwt
依	eor
黄	sk
修	ene
破	dvp
台	vlv
球	gf
呀	lh
院	cof
送	ugp
包	wc
义	owl
诉	oeo
攻	feh
丝	vvs
围	nav
玩	gfh
待	rh
复	qje
况	slq
楼	fpc
痛	pbt
梦	ffr
摇	ae
期	dw
英	skg
低	et
帝	ouy
兄	lqr
背	urw
持	ah
爷	twx
皇	egn
六	oti
穿	phy
杨	fvt
政	fne
运	svp
居	bdg
叶	ld
热	ayo
校	fot
谢	owa
曾	uju
细	vj
产	iq
睡	me
希	ws
速	flp
室	ohk
另	lxk
怀	yd
露	dn
异	csj
写	ys
鬼	wu
娘	cov
取	abu
式	gfo
除	ctf
级	vvo
考	hsk
建	xa
招	abl
饭	re
布	sm
续	vd
程	rlg
首	utk
观	bk
朋	wwy
务	exk
掉	amj
赶	dhg
忽	wty
术	fod
甚	dxi
差	ufo
呵	la
展	bs
争	yxv
品	ll
兰	usi
宝	ogo
香	rj
斗	sdi
故	deh
雷	djt
段	efq
顿	axd
角	ytn
疑	rq
护	aie
闪	pte
需	ds
调	owh
类	pg
妹	che
爸	twc
线	vfg
左	sfo
游	ioq
派	ier
谈	ouu
冰	skv
敌	reh
跳	nqs
支	dbu
约	vwo
您	eym
顾	svd
肯	nwy
醒	gj
铁	tq
抱	aw
淡	iu
造	wlp
伙	euo
资	sek
群	xq
集	wfv
联	au
商	ouk
号	ls
节	sx
讲	ost
掌	nt
赵	dwl
密	oy
九	yf
病	pfk
卫	xf
米	pm
威	dfc
继	vp
渐	ihe
统	vov
追	yp
亚	aue
简	qp
练	vav
基	dht
选	wqp
推	awi
改	beh
退	vpd
味	lhe
份	etb
举	ita
忍	boy
历	sxk
器	lls
恐	fqo
引	vn
试	ogf
习	xi
导	cac
存	sn
莫	sj
志	hy
区	gw
汉	ib
右	slv
严	auq
态	goy
买	vsg
幸	hud
社	hh
佛	evt
议	oow
树	fb
止	ni
块	hbt
守	oa
挥	ayh
胡	dwy
散	swe
仅	ebu
隐	cyx
怒	cby
床	ufv
苏	sxt
料	psd
股	wqh
局	bv
班	gug
图	nes
岁	jrk
礼	hx
独	rk
初	pbd
福	hfl
顺	qd
狂	rg
默	ns
巨	gb
既	xvg
松	ft
证	ofn
烈	frm
否	dl
恶	auy
治	iv
排	ali
费	vtk
拍	aeb
医	gq
温	ijm
府	ue
担	ajf
称	ry
余	tff
钟	tl
泪	imf
烟	un
仍	ev
具	mt
忘	uy
恩	ngy
毕	rrd
蓝	snq
陆	cax
究	py
抓	aek
压	sh
沙	imq
呆	lf
河	ia
迷	pp
枪	ftv
组	vm
权	fbu
叹	lbu
孙	vma
卷	ugv
查	fjf
毫	orm
春	gjr
圣	bh
草	sjd
较	ho
胜	wwg
遇	kp
充	ovq
史	lw
堂	nh
防	co
据	abd
猛	rvm
骑	xg
土	ht
卡	kmo
助	mxk
京	oma
银	tvn
永	okv
质	edk
屋	bhk
须	td
副	flj
换	ayk
刺	fkm
属	bq
闻	pa
境	hij
禁	ffh
阴	cw
共	sti
负	yk
弄	gs
翻	qpj
虎	mu
层	bsv
喊	ldf
逃	qs
晓	jaq
座	utt
雅	hwi
参	vg
射	wa
婚	cta
君	xql
划	gm
坚	nbh
价	ett
柔	cq
超	dbl
扬	av
科	rs
按	ao
狠	rvn
野	kc
秦	gr
秘	ryq
熟	ovy
置	md
仙	ejs
模	fsj
伸	ek
波	ivp
肉	ktt
假	ebs
齐	pti
舞	qsf
脱	wul
广	uu
姑	cd
投	aqh
顶	ad
致	heh
责	hkb
景	jom
营	syl
维	vwi
设	oqh
坏	hdu
啦	lai
秀	rvj
败	ke
眉	bmf
州	iqc
药	svw
承	vkf
案	ocf
狼	rov
专	sxo
偷	etf
画	fjx
吴	lfg
店	um
哦	lqa
弹	vu
欲	ttl
抬	avl
标	fhs
秋	ruo
厉	sfw
良	ovn
际	chs
状	usq
烦	ud
午	qdi
摆	amh
戏	bg
桌	mj
船	qql
短	qf
村	fac
某	ssf
摸	as
付	eac
演	iof
规	gkx
封	hha
握	abh
唐	ux
藏	sgx
震	dsn
虚	mk
纪	vbj
凌	sht
嘛	lp
梅	fqb
紫	nrb
临	nqj
毒	hbm
宗	ohs
著	shj
索	dyb
印	tfx
寻	xac
湖	idw
劲	bf
职	alt
技	adb
恨	yv
婆	ivc
杰	fuo
羽	xxi
咱	ltk
素	hbs
凡	qod
值	edm
飘	dhq
养	ugt
嘿	lne
普	uk
宁	oan
吓	lak
兽	ujf
夏	dme
读	odv
牛	wn
仿	eog
胸	www
浪	iov
富	ofl
宇	ofa
骨	mg
智	qlj
纷	vtb
升	qsj
叔	kmb
善	uul
弱	vsv
架	xlf
卖	dvs
袋	ego
网	kww
朱	wti
骂	llx
略	je
杯	fdu
环	gd
罪	mli
窗	pr
柳	ftm
厅	sa
搞	aol
端	ijs
洞	ik
适	rp
拥	at
释	qpb
洋	iug
肩	iwy
闹	po
洗	iw
灯	uan
伯	eeb
免	yl
菜	sef
验	xtf
凤	qbu
徐	rt
型	fsm
娜	cva
暴	jst
讨	oac
辈	lhc
懂	ysw
腿	wv
妙	cmq
危	ysv
优	edo
套	gh
丁	an
趣	da
妖	ceo
束	flv
杂	yfv
诗	oha
迎	tx
舍	thl
旧	nj
委	rc
笔	qrm
狗	rw
鲜	qug
纸	vta
抗	aoq
探	ayt
韩	dja
尼	br
控	apf
惜	ysj
珠	gwt
抽	ako
创	tvm
归	uxl
挺	aex
奋	gjt
陪	ci
硬	dfj
避	bl
园	nfh
托	aqa
训	oqc
勇	btx
聊	atm
奶	cvj
庄	uht
奔	gds
镇	tdm
研	dfs
配	gbj
介	tti
尊	uga
冒	ksm
虑	my
丹	wo
蛋	vnk
哼	lo
宋	ofv
济	ip
妇	cxl
箭	quw
择	aba
犯	rvi
欣	eei
甲	kj
欧	gwe
课	oj
扑	amo
菲	sli
燕	sfl
曲	ks
躲	wqf
玄	ovo
幻	vvi
茶	stf
折	aej
伊	exq
傻	erw
姓	cwg
源	ise
洛	iel
遍	in
臣	sc
弃	ovs
犹	rdo
占	mlv
漂	idh
挑	aqs
获	srs
绿	vx
峰	jed
疯	pq
森	fff
妻	dxc
恋	pyi
误	olf
拜	tfd
伟	eav
移	rrr
纳	vkt
党	nqr
罢	mhv
腰	wd
巧	fsk
孤	vq
闭	paq
圆	nl
碰	du
镜	tij
软	hei
厚	sjv
累	jbs
昨	jq
幽	jv
悲	lyi
丈	so
牌	twd
降	cea
颜	iqt
劳	syx
偏	ein
省	mqm
糊	pd
馆	rob
烧	uaq
谓	ojw
财	ka
舰	qk
汗	ihg
奈	ghs
操	all
迹	ppd
悄	ymw
残	frf
尖	mgd
鲁	qjr
锋	te
圈	nu
油	iko
俩	efk
项	fdk
撞	aik
瞬	mey
忆	yvi
盖	umn
尤	do
徒	rdk
乡	vqp
概	fxv
荡	siv
艺	svi
增	huj
祖	hm
困	nf
殿	bst
迅	vdp
律	rxa
企	tni
惨	yvg
限	cvn
聚	abe
凭	eeq
剧	bdm
碎	dot
躺	wns
缘	vbd
凉	som
织	vlt
抢	atv
替	gg
孔	vxi
康	uxk
惑	glf
唯	lwi
惯	ybd
登	bfl
互	fbm
盯	ma
稍	rmw
宣	ofj
唱	ljj
剩	rur
咬	lot
育	ovw
诸	ohj
触	ytk
晨	jsn
策	qfk
疼	pes
材	faq
补	pmo
私	rvv
吐	lht
纯	vax
艾	swl
贝	kb
庭	uex
挡	amx
晃	jm
吉	hlv
吹	lei
仔	evk
仇	eyf
凝	srq
鼓	hlu
农	yr
征	rfn
帅	umv
附	ce
缺	wb
豪	ods
亦	pi
杜	fht
努	cb
判	uam
谋	oss
胆	wjf
尘	mht
扎	axi
滚	iot
迟	bop
稳	ryx
翼	xxj
闲	pfv
灰	su
朵	qfv
盛	dvm
梁	ibt
晶	jj
餐	mrb
伦	etr
娇	cet
侧	ekm
愣	ymo
鼻	tja
轮	htr
昏	ta
抖	asd
陷	cyr
敏	qbe
词	ovf
慌	ysu
愤	yds
怜	yto
颤	on
阶	ctt
苍	stv
距	ngb
郑	ugc
川	qc
扫	axl
忧	ydo
童	ikk
丢	evv
臂	blo
逐	dpd
傲	ehw
戴	dgj
芒	suw
伴	eua
袭	dqo
供	est
积	rlt
测	ikm
遥	ewp
阻	cmi
例	efr
睁	myx
岛	yjs
瞪	mb
博	dfa
猜	rhw
益	utm
泽	iba
炼	uav
监	nqm
鸡	by
珍	gt
伏	esq
绍	vbl
爬	ecb
丫	uns
炸	uq
凶	wxg
郎	oxv
宿	oed
怨	rvy
醉	got
拼	aus
革	ge
瞧	mw
奥	rpg
输	htf
莉	srm
忠	lny
颗	jfd
嗯	lng
旅	oqr
仁	esi
鸟	ya
骗	xin
浩	iwl
塔	hsy
绪	vhj
枫	fqw
拔	asb
赞	wqw
炮	uwc
凯	jbq
邪	hcj
芳	sog
浑	iyh
夺	gac
宽	osk
旋	oqv
扭	abc
洁	ihl
浮	iev
悉	qpy
擦	aow
慧	dd
典	kst
赏	nk
评	ohu
纵	vtt
莲	shp
雾	dex
跃	neo
壮	uhf
贴	kml
隔	cf
健	exa
辛	ox
抵	ata
彻	rab
摩	ptu
轰	hbb
编	vi
肚	wht
插	awr
磨	pdh
哎	lsw
御	rqf
耐	sac
惧	ymt
氏	tai
辉	mhy
扶	agu
貌	yeq
述	fop
票	dhs
录	xkv
拖	aqc
膀	wou
鹰	uew
孟	vmn
递	uvn
瑞	gjs
货	erk
琴	ggt
踪	no
码	dxm
慰	bha
蛇	kor
玲	gto
晕	jyh
损	alk
轩	hhg
粗	pmi
掩	agk
屁	brr
仰	etx
零	dt
盟	jwm
贼	kgs
洪	ist
悟	yfc
固	nd
讶	ohy
滑	img
郁	swc
辆	hfk
猪	rhj
妮	cbr
挣	ayx
旦	jfi
估	edg
坦	hjf
甘	ssi
佩	eqf
莱	sfp
享	ovk
吼	lvx
构	fwv
粉	ptb
萨	sci
吻	lwt
潜	igg
瓶	usa
偶	eky
戒	gsj
浓	iyr
毁	rfq
销	tmw
迪	kpd
拒	agb
绕	vaq
勒	gx
嘻	lhl
尾	brm
帐	mth
废	uxb
延	qn
敲	omb
烂	uus
曼	jmb
厌	ssq
宜	omi
羞	ub
喂	ljg
吟	lto
滴	iou
洲	ii
爹	twr
艳	dyc
晴	jh
抚	af
缩	voe
协	dxt
央	kgd
悔	yqb
肖	mwy
缠	vuk
脆	wys
痕	pvn
伍	efc
寂	okm
启	ilv
翔	uxx
薄	sif
侯	ebq
劝	bx
郭	ovc
奴	cbu
鸣	lya
彼	rvp
扔	avj
撒	asw
豫	cyl
检	ftf
针	tdi
耀	mhx
痴	pql
姆	cbm
篇	qi
椅	fga
熊	vwr
狐	rqu
蒋	sur
踏	nkj
隆	cef
括	are
唉	lvq
穷	pxk
聪	aul
唤	lyk
泰	gkv
旗	oqd
仪	eow
焦	wuo
猫	rsj
侍	eha
挤	apt
款	hhe
拾	aye
荒	suq
姿	sec
域	hgl
搭	asy
脉	wok
授	aey
融	flk
狱	ros
欺	dei
访	oog
桥	fet
锁	tmk
霸	dgw
牵	gy
池	ic
钻	tml
喃	ldk
廷	exn
玛	gxm
奉	gao
扯	ani
减	sdf
夹	gue
辞	rox
岸	jsh
岂	jbj
屈	bxx
恼	ypx
哲	ael
季	rvk
召	blv
丧	dug
尝	nsv
载	dgh
瘦	prn
皆	rre
颇	vdk
茫	siu
染	iyf
肃	xtt
爽	gww
吞	fgl
惹	ssl
乔	eti
趁	dtt
铺	tfu
脏	wuh
吕	llv
奖	urg
倍	eil
振	asn
婷	coa
牢	own
扰	ado
溜	itj
庞	udq
臭	tsq
悦	yul
赢	ukb
跪	ny
枝	fdb
侠	egu
泉	ekv
劫	hvx
泥	ibr
赌	kh
魏	rcw
罩	mm
疾	pqi
饰	rqm
符	qea
垂	esj
映	jkg
漠	isj
脖	wdy
饮	rei
沿	iql
懒	yfl
肤	wgu
桑	bbb
堪	hdx
燃	uws
卓	mjd
祝	hlq
赖	fly
宾	oef
贾	dkb
喘	ljs
焰	uyr
吵	lm
冥	yjo
鞋	ghh
逸	ylq
均	hws
库	uhc
裤	pu
碗	dor
航	qoq
踢	njw
姨	cg
酸	gv
啸	lxt
龄	ntx
阁	pel
箱	qfm
冯	sxm
邦	dcj
钢	tkw
促	env
泡	iwc
碧	ged
援	aeh
忌	byi
抹	aho
锐	tul
喷	lds
袖	pk
殊	frw
络	vel
嫁	cod
咒	llq
撤	aov
键	txa
湿	ijk
恰	yy
审	oke
贤	nbk
葛	sjw
刹	wfm
袁	hlr
序	uc
筑	qfq
涂	itf
湾	ipv
莎	sim
崇	joh
墨	nht
娃	chh
梯	fuv
桃	fqs
豆	flu
驾	xlx
浅	ifg
径	rb
饿	rqa
疲	pvp
搬	aqq
莹	syg
滋	iuv
润	ipg
铃	tto
蛮	pkc
蒂	sou
涛	ida
予	cu
勾	wvv
惠	gyi
析	fej
撑	ant
措	asj
币	qmv
薇	srf
愈	tfw
酷	gwl
祥	hug
怖	ysm
侵	exy
岩	jdh
扮	atb
盈	vbm
斩	hej
尺	bod
签	qt
稀	rws
夸	gfs
汽	iqq
液	ioe
姬	csc
愧	ywu
汇	igf
粮	pov
堡	elf
仗	eso
笨	qff
奏	gfg
歉	uxn
甩	wxi
怔	yfn
允	vqr
竞	ilq
祸	hlk
耶	acj
爵	emx
绩	vhk
诱	orv
呜	lew
黎	rwq
租	rmi
砸	dgm
麽	pqv
窝	plk
弥	vym
返	ebp
匹	hxi
啥	lth
凑	sgf
奸	chg
陌	cdj
叛	uae
核	foi
卧	smo
幅	mfl
眨	mqp
耗	dtr
洒	idx
怡	yvl
详	oug
卢	mbh
扣	alv
哇	lhh
丑	bc
孝	hvk
矛	cqp
氛	qtb
衡	rqt
陶	cww
购	kwv
汪	ign
疗	pvl
妃	cbj
罚	mo
棋	fdj
缝	ved
咐	lea
躯	wgw
泛	iqp
愁	ruy
搜	arn
慈	uvv
肥	wcb
笼	qdq
篮	qnq
俱	emt
惟	ywi
柜	fgb
捉	anv
悬	mvy
霍	dwi
泄	ihi
秒	rmq
勤	gsx
屏	bus
霜	dfm
袍	pwc
蝶	khf
祭	whs
胁	wxt
璃	gpx
赚	ku
锦	tem
尴	dnq
熙	scu
寺	ha
昌	jjr
贺	xlk
捕	afu
陵	cht
咳	loi
扇	ix
虹	kfo
绵	vem
撕	ade
蔡	swh
催	ejw
宠	odq
贪	tov
誓	aeu
盒	ymn
披	avp
饶	raq
搂	apc
跌	nqg
肌	wqj
抑	atx
纹	vpw
宏	osv
幼	vxk
萍	sih
驻	xog
丛	ttf
亿	evi
播	aqp
俄	eqa
挨	avq
仲	eln
迈	fwp
辩	ooo
埃	hvq
艘	qrn
琪	gdj
灾	ouo
僧	euj
渡	ius
卑	wdi
鼠	rbu
讯	ovd
艰	bvn
斥	eod
裙	pxq
翠	xxo
饱	rwc
掠	aom
询	owj
勃	dyv
矮	qrc
瑶	gew
赐	kjw
捏	ajh
闯	pxm
姚	cqs
瑟	ggy
渴	ijw
谅	oom
昂	jtx
串	lln
沟	iwv
涉	inm
咕	ldg
驶	xlw
摄	aab
贫	tbk
辕	hhl
婉	cor
碍	djf
荷	sea
冠	yfh
魅	whe
玫	geh
裁	dgo
坡	hvp
鸿	ify
邓	bcj
歪	dfn
乏	qpe
巫	ftt
衫	pto
阔	pir
泣	iid
韦	avi
恍	ymh
贯	bdk
魄	ewu
柄	ffk
覆	dr
蜜	oyq
婴	kkc
锅	tlk
陛	cr
帕	meb
咖	lxl
嫌	cux
胳	we
挖	apv
啪	lae
眠	mc
穆	rem
啡	lli
吾	fcl
坛	hsv
脾	wwd
恒	yfj
屠	bhj
玻	gvp
蓉	sp
耸	tta
膊	wfa
後	rve
逆	uxp
寿	dac
驱	xgw
猴	reb
佣	etn
毅	idq
舅	rjx
铜	tkf
娟	clw
眯	mp
吩	ltb
匪	gli
牧	weh
役	rqh
寄	oga
诡	oys
纤	vwk
腐	uea
姻	cng
晰	jfe
渊	itp
邀	eoe
哄	lst
骚	xbo
柯	fal
筋	qwx
崔	jwi
灿	ujs
捷	afx
淋	iff
弗	vti
辑	hla
绳	vlk
频	nmd
廊	uox
畏	jg
裹	ojf
苗	sjt
盼	mtb
咯	lel
耍	scn
煞	yxe
寝	oux
瞒	ms
嫂	crn
纠	vxg
嚷	lol
驰	xc
拐	alx
宴	ojc
津	ixa
岚	jqw
浴	itt
挽	ayl
誉	itu
乳	evx
仓	tvi
逝	aep
喉	leb
逛	rgp
樱	fkk
哗	ler
涯	ish
捧	aga
铭	tr
障	cij
摊	abw
跨	ngf
妥	ecn
揉	acq
晋	auj
寞	osj
漆	ift
污	ifs
嘲	ldj
吊	lmv
乾	djq
馨	hbq
伪	eox
嗓	lbb
呈	lg
卿	txv
籍	qdt
裸	pjf
链	thp
灌	isl
畅	kvt
逍	mwp
帽	mks
阅	pul
蹲	nug
踩	nef
窜	pll
哑	lau
趴	nti
逢	edp
植	fdm
媒	css
昭	jbl
尹	xqp
档	fmx
趟	dns
沾	iml
朴	fmo
瞎	mod
鞭	gef
俺	egk
翅	dbx
肠	wvt
雀	mwi
慎	ydm
盆	tbm
迁	wpd
镖	tdh
芬	stb
丘	efi
蠢	gjk
庙	uko
拓	adh
纱	vmq
漏	ibd
谨	ogs
仆	emo
宙	oko
屑	bmw
叮	lan
捂	afc
涩	ibo
诧	ooq
柴	nrf
杆	fhg
涵	ivk
坠	cth
赔	ki
嘟	lhj
崩	jww
薛	syo
藤	swu
税	rul
枯	fdg
译	oba
帘	pmv
糖	pux
愉	ytf
骄	xet
羡	use
糕	puu
彬	fft
愚	ky
疏	vno
堵	hhj
腕	wor
眸	mvw
芸	ssv
殷	exv
谎	osu
鼎	mxt
稿	rol
哟	lvw
冤	yyl
症	pfn
咧	lfr
湘	ifm
嫩	cfl
肆	hxa
宰	oox
憾	ydf
腔	wpf
哩	lkk
豹	ywo
瑰	gwu
鉴	nqw
绑	vdc
潇	isx
戚	dkm
桂	fhh
兮	tsk
雯	dpw
颠	dmt
狮	ruf
契	dbg
骇	xoi
揭	ajw
坑	hoq
伐	egg
矩	qgb
葬	sfr
诀	obt
鄙	ldn
柏	feb
溃	ilk
朕	wug
躁	nll
霉	dqb
侦	emk
冻	sam
娅	cau
筹	qda
削	mwm
砰	dhu
耿	auo
牺	wdx
筒	qkf
遂	udp
旭	yjr
胎	wvl
惶	yeg
痒	pug
竖	nbi
龟	ykd
斑	gpg
儒	eds
嫣	cfn
宅	oqa
押	akj
胃	jwy
旨	rjr
册	wwf
膝	wft
浸	ixy
栏	fus
衷	onr
艇	qex
岗	jkw
赴	dmo
囊	dly
斧	twe
颊	gud
疆	vhf
炉	uie
塌	hjx
旺	jgn
乞	qvi
烤	uhs
逊	vmp
贱	kfg
愕	yll
晌	jrn
麟	ipr
腥	wjw
粒	pid
拟	axo
俏	emw
杖	fso
芝	spe
夷	gvg
衬	pac
佐	esf
巷	stc
捡	atf
桶	fbt
泼	ixb
滩	ibw
琼	gom
昊	jfg
帆	mqo
搏	afa
颈	bfd
噢	lrp
寡	odm
贞	mkb
凰	qeg
哨	lmw
拆	aeo
茹	scl
劣	mqx
嘱	lbq
沃	ieo
厢	sfm
摘	aou
咋	lqm
坤	hke
俯	eue
媳	cty
嘶	lde
贡	fkb
碌	dxk
拢	adq
谭	odj
翁	tvx
辜	dox
廉	uux
械	fgs
贸	tkb
辅	hfu
讽	oqw
呐	lkt
斌	pfg
填	hdm
窃	pab
溢	iut
抄	amq
妒	cie
吁	lfa
嗦	ldy
掀	aee
芙	sgu
栋	fam
吱	ldb
撇	aum
胞	wwc
轿	het
妨	cog
拂	avt
衰	ofr
循	red
挪	ava
蓬	sed
垃	hid
账	kth
驳	xw
署	mhj
顽	fhd
姥	chr
圾	hvo
熬	hwe
枕	fy
咦	lgv
厕	skm
攀	fww
彤	wot
妍	cfs
拽	akq
荆	sfs
妓	cdb
壶	hyk
於	ots
鹤	ywy
钥	twy
骤	xab
渺	imm
刊	hmd
肢	wdb
烛	ukc
孕	vvk
绽	vof
棉	fem
俘	eev
盔	sum
剪	uwm
诞	oqn
凛	son
岭	jto
嚣	lld
溅	ikf
笛	qko
舱	qtv
鸭	kya
噬	lqf
钉	tan
躬	wvg
倚	ega
缕	vpc
咚	les
撼	adf
蕊	syy
侄	ehk
佑	esl
雁	sew
践	nfg
拱	ast
沐	ifv
菊	swp
蜂	ked
裕	ptt
兆	qss
搅	aiy
尿	bkv
黯	nij
歹	frk
蓄	sov
朦	wsy
嘀	lou
怯	yhv
叨	lbd
纽	vbc
聘	aks
腻	wgs
剥	xkm
彪	mto
氓	uca
榜	fou
逻	mrp
壳	hyq
储	eoh
啤	lwd
匠	gej
悍	yjh
昧	jhe
泊	ieb
篷	qed
狡	rot
轨	hyf
汹	iwx
携	awv
磊	ddd
隙	cmj
仑	tri
瞄	msj
胧	wdq
趋	dyx
挠	aaq
煌	ueg
擅	aon
卒	ott
饼	rus
狭	rgu
惫	ejy
瞅	mru
犬	sq
砖	dsx
矣	vqi
昔	sjr
裳	nor
骆	xel
雇	iwi
阎	pyr
骷	mdg
鸦	hya
妞	cbc
墅	kch
焚	ffu
绘	vts
梳	fov
肿	wln
魁	wsd
耽	ayq
擒	atp
陡	cdk
璋	gij
茂	sdw
蹄	nou
瞥	umt
瞳	mik
髅	mpc
绣	vr
硕	ddk
炒	umq
邮	kcj
嫉	cp
届	bko
嗡	ltv
娱	clf
喧	lof
脂	wr
膛	wnh
沧	itv
疚	pyo
盐	hmm
扁	inc
搁	ape
茅	scq
坟	hpw
掐	ayr
瑜	gtf
茵	sng
苹	shu
旷	ju
蓦	sjg
诈	oqm
沫	iho
菁	shw
粹	pot
琢	gdo
腊	wsj
钦	tei
喻	ltf
宪	owq
锻	tef
饥	rqj
侃	elq
粘	pml
媛	ceh
恳	vyi
厮	sde
锤	tes
聂	abb
贩	keb
翩	inx
呻	lke
枉	fgn
拘	awl
煮	hju
焉	fns
址	hn
匕	ri
渗	ivg
览	nqk
敦	ove
厦	sdm
冉	kht
呃	lsv
峻	jvt
荐	ssn
栽	dgf
嚎	lod
汁	idi
傍	eou
磕	dhv
珑	gdq
邵	blc
窄	pqm
阮	cfh
蹈	ner
碑	dwd
婶	cok
煤	uss
寓	oky
栈	ffg
滞	isy
倘	ens
杭	foq
狈	rkb
峡	jgu
侣	ell
芦	sie
蔓	sjm
蒸	svk
禄	hxk
胀	wth
淌	ins
伞	tud
姊	cqx
钩	twv
衍	ria
妾	icn
嘎	ldm
蜀	mwk
蝴	kdw
萝	smr
莽	sss
弩	cbv
祷	hda
稚	rwi
圳	hq
徽	rfb
衙	rfc
咸	dfl
陋	cfk
奢	ghj
罐	wsl
霄	dmw
毙	rrf
敞	neh
嘘	lmk
灼	uwo
澜	ipf
倪	erq
挫	att
咪	lpm
钧	tws
捣	ayj
燥	ull
泳	iok
焕	uyk
酬	giq
筷	qyb
宵	omw
缚	vfa
揪	aru
蚁	kow
喇	lfl
拎	ato
棠	nfv
咙	ldq
棺	fob
璇	goq
肝	whg
剂	ptm
疤	pcb
渔	iqy
沮	imi
皓	ewl
勋	lkx
恕	cly
虐	mxl
虞	mlf
综	voh
瘾	pcy
驴	xie
晒	jdx
卦	hhm
迦	xlp
窥	pgk
堕	csw
哆	lrr
葡	swf
帖	mml
屡	bp
鹅	qag
蛛	kwt
盲	umf
碟	dhf
狞	roa
囚	nte
揽	anq
裴	lor
吏	flw
铮	tyx
萄	sww
盏	fgm
喔	lbh
勿	wto
吭	loq
淘	iww
蔑	smd
淹	igk
麒	idj
喽	lpc
栗	dfv
绷	vww
惚	ywt
桓	ffj
桩	fuh
坊	hog
履	brq
璐	gne
菩	sil
巢	vjf
畜	ovj
锡	tjw
仕	ehf
芹	sej
僻	ebl
絮	clb
浆	urk
瘫	pbw
啧	lhk
磁	duv
冈	kwl
逮	xkp
搓	auf
赠	kuj
脊	sst
噩	gll
绰	vmj
呕	lgw
嚼	lem
谐	orr
揣	ajs
殖	frd
拧	aoa
伺	evf
霖	dff
驼	xor
襄	ols
衔	rta
惕	yjw
掷	aug
卸	qfn
炽	ult
惭	yhe
框	fgg
捆	anf
眩	mov
谜	op
炫	uov
塘	hux
阱	cst
亨	ovl
奕	pgd
蚂	kxm
猩	rjw
沁	iyi
跋	nsb
藩	siq
舔	rfg
捐	alw
歧	ndb
隋	csf
蹭	nuj
甄	dha
蜡	ksj
嗤	lxf
缸	wfo
嬉	chl
哮	lhv
熄	uty
窍	pfs
掘	abx
琦	gga
屎	bpm
乍	qmo
弧	vqu
槐	fwu
铠	tjb
襟	pff
梨	rmf
嗅	lts
纲	vkw
渠	igb
捅	abt
扛	afo
忖	yac
匈	wwx
扒	ati
侮	eqb
闺	phh
霓	drq
稽	rdr
斋	psr
沦	itr
揍	agf
瞟	mdh
漪	irg
暑	jhj
窟	pbx
钓	two
鳞	qpr
萱	sof
株	fwt
倭	erc
鞘	gmw
绞	vot
颓	rqd
睿	myf
噗	lku
唔	lfc
喀	loe
拣	aav
谣	oew
叽	lqj
葱	swt
婢	cwd
铸	tda
绮	vga
胤	qvw
秩	rqg
畔	jua
粥	vpv
绸	vwh
茨	sse
熏	wne
蹬	nbf
诏	obl
岔	tbj
叭	lti
咆	lwc
滥	inq
梧	ffc
垮	hgf
澳	irp
浙	iae
甸	wjt
绯	vli
诛	owt
鲍	qwc
刁	vfi
厥	sux
蚊	kpw
鞠	gwp
拙	axx
茗	srl
眷	ugm
戮	xxt
唬	lmu
骏	xvt
踹	njs
漓	ipx
蝇	kl
擂	adj
沌	iax
凸	nfn
酿	gov
蚩	xfk
琐	gmk
犀	bkw
澄	ibf
哉	dgl
猾	rmg
窒	phk
虾	kak
蝠	kfl
钞	tmq
瓣	oqo
唧	lxv
觑	mkk
哽	lfj
娥	cqa
讪	ojs
耕	dts
暧	jey
浇	iaq
嗨	liq
疫	pqh
兢	dqd
箫	qx
颅	mbd
绅	vke
杉	fto
嗜	lhr
券	ugb
炯	ukl
霎	dic
迭	qgp
彷	rog
觅	ekx
娴	cpf
抿	aca
稻	rer
敷	foe
泻	iys
怠	vly
龚	dqs
绒	vgs
讳	oav
勺	wod
函	vkx
颂	tvd
巍	jrc
脯	wfu
漾	iuo
缴	veo
藉	sdt
逞	lgp
膏	owy
戳	xxw
凹	kfi
叩	lxj
禽	tpx
懊	yrp
懈	yyt
蛟	kot
芊	swk
慑	yab
跺	nqf
跄	ntv
蚀	rkc
栖	fdx
蔚	sbh
铲	tiq
坪	hhu
筝	qyx
腮	wjy
踉	nov
踱	nus
嗖	lrn
苑	srv
秉	rxl
猿	rhl
佟	ees
悯	ypp
唠	lsy
肘	wac
拇	abm
婕	cfx
啃	lnw
匀	wsi
怅	yth
聋	dqa
拯	avk
忿	tby
韧	avb
邹	yxc
梢	fmw
肋	wxk
辖	hod
浦	ifu
炭	jsu
曦	jur
螺	kjb
屯	axg
悴	yot
匡	ggn
冀	urj
倔	ebx
橙	fbf
陕	cgu
筱	qen
叱	lri
髓	msf
矜	cqt
詹	yst
芷	sni
浊	ikc
囔	ldl
朔	uxw
睫	mfx
睬	mef
鸽	yya
吨	lax
笙	qwg
戟	djg
沼	ibl
谍	ohf
昕	jej
蛊	kmn
煜	uji
祀	hck
罡	mfn
伶	eto
荫	scw
酥	grh
峨	jqa
轴	hko
伽	exl
捶	aes
檐	fys
棘	fkf
嗣	lnv
钗	tbo
袜	pho
妩	cfd
炕	uoq
偎	ejg
窦	pdv
溶	ipt
峙	jha
缉	vla
徊	rnl
呗	lkb
衅	qmu
砂	dmq
舵	qor
昼	boj
迸	usp
斟	dxs
舆	rhf
靓	hwk
旬	wjr
窑	pwo
萎	src
涟	ihp
瘩	psy
梵	ffq
靴	ger
侥	eaq
匿	gss
兑	ulq
徘	rli
芽	shy
闵	ppw
嗷	lhw
芯	syi
邢	fsc
绊	vua
蜘	kq
憎	yuj
靡	pli
褚	phj
嚓	low
珂	gal
崽	jjy
婵	cuj
悸	yrv
晦	jqb
涅	ijh
恬	yre
慷	yux
渣	ifj
屉	bhi
缭	vgu
绢	vlw
嬴	ucn
黝	nvx
袅	yor
茄	sxl
寅	ofk
悻	yhu
祟	xxh
蛙	khh
苇	sav
嵩	jol
茉	sho
唰	lbm
咏	lok
凿	kud
粪	pst
噪	lll
菌	snr
蝙	kin
邸	tao
晟	jdv
攒	awq
虔	mpw
旱	jhg
琛	gyt
榴	ftj
漱	ifl
忑	ayi
匣	gkj
忐	kyi
钝	tax
惘	yku
漉	iil
蟹	ytb
佬	ehr
曳	kqp
赎	kdv
壤	hol
忡	yln
冶	svl
姝	cwt
筠	qhw
竿	qhg
嘈	lsj
蚕	fgk
剖	ilm
颁	tbd
缀	vbb
汀	ian
谕	otf
斐	lpw
皙	fee
缪	vxx
蔷	sdu
恤	yqm
咄	lxx
馒	rjm
矫	qet
痞	pdl
橘	fcq
贿	ksw
肮	woq
瑾	ggs
烙	uel
攥	aqm
汰	igo
溺	ivs
铅	tql
咔	lkm
芭	scb
戎	gso
褐	pjw
吆	lvo
彰	ijt
棕	foh
鹃	lwy
帜	mlt
鄂	llf
蔼	soj
穗	rgy
亩	ojt
绎	vba
牟	vwn
咨	sel
奄	gkd
梓	fox
绚	vwj
阀	peg
烘	ust
驯	xqc
栩	fxx
墟	hmk
鬟	hmf
骸	moi
峭	jmw
缅	vgi
洽	iye
暄	jof
裔	ork
韶	ijb
缎	vef
砚	dkx
锥	twi
辙	hov
惦	yum
铛	tmx
枣	fks
桦	fer
邃	pud
橱	fsf
搔	abo
腑	wue
萤	syk
枢	fgw
庵	ugk
叼	lvf
嫖	cdh
苛	sal
锣	tmr
蹑	nab
拌	aua
殴	gwq
喋	lhf
糙	pwl
貂	ybl
葵	sbf
颐	sdk
皂	eai
眈	myq
扼	asv
眺	mqs
孜	veh
簌	qfl
玺	ymg
偌	ess
蹿	np
弛	vc
庇	urr
檀	fon
螂	kox
趾	nn
妲	cjf
掺	avg
驿	xba
惬	yg
抡	atr
憧	yi
宦	osc
筐	qgg
瞻	mys
俨	eau
跷	naq
撅	asu
煽	uix
呱	lqu
缰	vfj
衮	otv
肴	wsw
殆	frv
谴	olk
蔬	svn
飒	iqw
婧	chw
阐	puj
荧	syu
侈	err
霏	dli
瘟	pjm
芜	sfd
崎	jga
亥	oi
俐	erm
屿	jsf
垄	dqh
畴	jda
杠	ffo
鬓	hoe
晏	joc
弈	psj
鞍	goc
钮	tbc
珏	ggo
钰	tgo
噔	lbf
驭	xbu
靶	gc
萦	syb
韬	ave
恙	uyi
竺	qsi
吝	plv
羁	mgx
荀	swj
癫	pdm
菇	scd
恃	yha
踌	nda
榕	fpt
昵	jbr
躇	nsh
烬	ubo
啰	lmr
酌	gwo
丙	fkt
涎	iqn
鸾	pya
砌	dab
烨	uer
噎	lhy
驹	xwl
噼	lbl
咎	eml
亵	oay
陨	clk
蠕	kds
冕	ksy
雌	nrw
茸	sar
瑛	gsk
掰	ttb
橡	fyl
佯	eug
笃	qxm
崛	jbx
稼	rod
桀	raf
汐	irk
锈	trv
磅	dou
娄	pcn
撮	aja
玑	gqj
祠	hvf
黏	rtk
珀	geb
睽	mbf
栓	ftg
邑	lcb
瑕	gbs
磋	duf
粟	dpm
薯	smh
沪	iie
讷	okt
玮	gav
迂	fap
伎	edb
鲸	qom
洼	ihh
蹊	nev
寐	oxh
肾	nbw
鸯	kgy
這	up
涧	ipj
崆	jp
甭	dtn
笠	qid
扈	ilc
哝	lyr
芮	skt
卉	dsj
诬	oft
札	fxi
扉	ili
疮	ptv
巅	jdm
坞	hew
剌	flm
鳄	qll
捺	agh
悼	ymj
茧	skc
毋	bso
馅	ryr
曙	jmh
簸	qdv
妳	cym
叟	rnb
拴	atg
嬷	cpq
稣	qrh
痹	pja
垣	hfj
蛤	kye
蛾	kqa
瑚	gdw
個	end
熔	upt
雏	yxw
惆	ywh
饷	rrn
拗	avx
燎	ugu
薰	swn
蕃	sqp
捋	aea
髦	hrm
飓	qwm
簿	qif
迢	blp
汩	ije
闸	pkj
蜥	kfe
胯	wgf
侨	eet
劭	blx
烹	ovu
咣	lmh
鸥	gwy
寰	omf
紊	pbs
稠	rwh
垢	hef
楷	frr
炊	uei
忻	yej
炳	ufk
腆	wks
酋	ugo
赃	kuh
拈	aml
抒	acu
袄	peo
孺	vds
胭	wng
礁	dwu
嫡	cou
珉	gca
钳	tss
隧	cud
窿	pce
骋	xks
嫦	cnm
槛	fnq
曜	jxx
遐	bsb
蹋	njx
飕	qwr
渍	ihk
麾	prm
猥	rjg
篝	qsk
枷	fxl
蜒	kqn
皎	eot
霁	dpt
咫	bol
檬	fsy
奚	evg
溯	iux
纺	vog
篱	qpx
刨	wcm
忏	ywk
盎	kgm
戾	isq
咀	lmi
屹	jqv
羔	uuo
庚	uxt
隘	cut
绛	vea
焘	dau
璨	gmr
跤	not
锵	tur
摁	ang
痊	ptg
嫔	coe
臻	hgr
泯	ica
糜	ppm
缥	vdh
褥	psa
魇	ssw
汶	ipw
馋	ryl
渎	idv
抠	agw
棣	fxk
沓	kjr
喏	lss
诲	oqb
琶	ggc
缈	vmm
缔	vou
酝	gsv
耷	gar
弼	vdj
柬	fnu
拷	ahs
柿	fom
琵	ggr
沂	iej
蕙	sgy
帛	emv
柠	foa
饵	rar
撂	aje
乓	efo
轲	hal
髯	hkh
娉	ck
圭	hht
璀	gjw
肪	wog
瞩	mbq
啄	ldo
蟑	kij
炖	uax
捎	amw
瞿	mmw
嗬	lse
蘑	spd
唏	lws
鹊	sjy
矶	dqj
羌	uxi
骼	mel
筛	quf
羲	urs
祺	hdj
馈	rlk
伫	eof
羿	xxs
铎	tba
啬	dun
舷	qov
矗	dmd
癖	pbl
匾	gin
瀛	iuc
珞	gel
衲	pkt
毓	qbo
恺	yjb
惰	ysf
诣	orj
谛	oou
啷	lox
佘	ths
黠	nhl
饲	rvf
虬	kxi
涤	ief
骡	xj
邯	ssc
笋	qxq
芥	stt
醺	gwn
舜	eyr
簪	qgq
蹂	nc
恻	ykm
甥	wjx
腼	wgi
驮	xgd
潺	ibv
锭	tof
粤	rps
琏	ghp
椎	fwi
唆	lvt
煦	jwl
嵋	jbm
毡	rml
碳	djs
鸨	rdy
躏	nsp
蜓	kex
咻	lef
睨	mrq
桔	fhl
娆	caq
玟	gpw
徨	reg
嗲	ltw
哐	lgg
粼	pra
谑	omx
甬	btn
榨	fpq
倜	ewh
稷	rjt
妤	ccu
篡	qmg
晤	jfc
肇	iex
咂	lgm
帚	xy
瘤	ptj
瞠	mnh
怆	ytv
镔	toe
撵	agg
裆	pmx
腺	wek
骁	xaq
螃	kou
锢	tnd
晁	jqs
蝗	keg
烽	ued
辘	hil
莘	sox
瓮	tva
钊	tmd
篓	qpc
泓	ivv
宸	osn
鞑	ggp
胄	kwy
羚	uto
绥	vec
笺	qfg
荤	syh
迄	qvp
踞	nbd
桨	urf
噤	lff
幌	mjm
荻	sru
痪	pyk
腋	woe
骰	mqh
曝	jjs
涮	ibm
踵	nwk
俟	evq
皑	ejb
瞑	myj
赂	kel
麓	ffi
铿	tnb
峦	pjs
噘	lsu
涓	ilw
掬	awp
怏	ykg
莓	sqb
萃	sot
呲	lnr
蹒	nsf
睐	mfp
昱	jid
摞	ajb
們	ekn
吠	lsq
濮	iek
卞	omo
琬	gor
谙	oij
啕	lww
轶	hqg
搪	aux
陇	cdq
纨	vyo
皋	egd
霭	doj
橄	fva
纶	vtr
垛	hqf
嗫	lab
盅	lnm
拄	aog
踝	njf
臧	gxs
岌	jvo
岱	egj
璞	gku
缄	vdf
秧	rkg
卤	mnw
靥	ssg
磐	qqd
斓	ppf
翊	ixx
叁	vgf
阖	phv
怂	tty
汲	ivo
垠	hvn
迥	klp
咛	loa
杞	fbj
痘	pfl
媲	crw
辄	hax
恪	yel
砾	dtm
痉	pbf
蜕	kul
仨	efa
纣	vac
馁	rec
镐	tol
蜈	klf
窈	pvx
說	utl
秤	rhu
桢	fmk
悖	ydy
汴	iom
隅	cky
琥	gmu
阚	pva
杵	fqd
掖	aoe
婀	cca
昙	jsv
坍	hwo
俑	ebt
滤	imy
侏	ewt
潦	igu
覃	djd
硫	dov
梆	fdc
驸	xea
笈	qvo
忱	yyq
恿	bty
胥	vnw
垦	vht
窕	pqs
滇	idm
邬	ecj
圃	nfu
咿	lex
瘴	pij
舫	qog
泞	ioa
藐	sye
逵	hth
戍	dod
榭	fwa
牠	wcy
蟾	kys
霾	dyk
蔫	sfn
跛	nvp
岐	jdb
脐	wpt
糗	pts
螳	kn
哺	lfu
蚣	ktv
炀	uvt
嵬	jwu
隽	wvj
籽	pvk
釜	twh
磷	dpr
沒	iwb
谄	oyr
恣	sey
溟	iyj
丕	dfi
峒	jkf
芋	sfa
觊	jbk
旖	oqg
筵	qqn
娣	cuv
盹	max
涸	ind
颌	ydk
劾	oxk
趔	dfr
殇	frq
噌	lu
沽	idg
愫	yhb
鸢	gya
玷	gml
溥	ifa
疵	pnr
聿	xao
镀	tus
祎	hav
崴	jdf
岖	jgw
蝈	kng
雒	elw
镑	tou
臆	wi
蜗	klk
瞰	mva
郸	ujd
缆	vnq
楮	fhj
诠	otg
麼	pvo
犊	wdv
蟀	kov
荦	syw
竣	ivt
骥	xur
贲	dsk
胴	wkf
潼	iik
弑	wfg
匐	wfl
姣	cot
蘸	sgw
渥	ibh
蛐	kks
阂	poi
糯	pds
愠	yjm
嵇	rdj
绾	vob
舀	erj
噙	ltp
嘣	ljw
诃	oal
脓	wyr
樟	fi
捱	ash
阜	ydi
峥	jyx
濡	ids
瑙	gvr
碉	dwh
荃	stg
嗵	lbt
彝	bpb
篆	qbd
臾	rte
椭	fcs
沏	iab
蛆	kmi
淆	iws
辎	hvj
踮	num
鳅	qru
荔	sxx
會	tfj
隗	cwu
渤	idy
锏	tpj
遛	tjp
倌	eob
氤	qng
嶙	jpr
馗	yut
匮	glk
揶	aac
胚	wdf
敕	fle
夙	qfr
锹	tru
珈	gxl
迩	ymp
啾	lru
靼	gjf
蓟	sqm
沅	ifh
馥	rjq
槌	fyp
為	oww
褛	ppc
贻	kvl
豚	wds
礴	dsi
氲	qjm
腌	wgk
蚱	kqm
殡	fro
耙	dtc
诽	oli
褴	pnq
恁	eey
呷	lkj
蚌	kdn
铝	tll
憩	rty
俾	ewd
鬃	hoh
祢	hym
苒	skh
鱿	qdo
唷	lov
傥	enq
袈	xlo
豺	yaq
町	jan
坯	hdf
戛	dmg
贮	kof
剽	dhm
孬	dcv
衩	pbo
镣	tgu
夥	jfr
過	npd
匝	gmv
珩	gra
诘	ohl
攫	amm
潢	isk
黔	nto
臃	wov
罂	kkw
酗	gwx
阪	ceb
冗	yqj
桧	fts
闳	psv
皿	mn
囡	ncn
闰	pgn
怵	yfo
囤	nax
罔	kuu
蚓	kvn
姒	cxo
灸	you
蚯	kef
嗥	leg
箴	qdf
谗	oyl
嵘	jsy
箩	qmr
碱	ddf
谆	oov
粽	poh
牒	thf
泸	imb
蔺	spw
刽	tsv
诋	ota
惇	yov
缜	vdm
爻	wwl
睑	mtf
葭	sbs
昀	jws
經	bfv
妪	cgw
噫	lij
镂	tpc
癸	bfg
沣	idn
笆	qcb
绉	vyx
抨	ahu
箕	qdj
叵	glv
坨	hor
颉	hld
姹	coq
赳	dxg
琮	goh
焊	ujh
埠	hyd
泱	ikg
淙	ioh
榛	fgr
酵	ghv
銮	pwj
嗳	ley
佶	ehl
犒	wol
饪	ren
泠	ito
砺	dsf
遽	mdp
嗟	luf
钙	taf
谚	oiq
雉	qwi
虱	vqk
锴	trr
赈	ksn
骠	xd
峋	jwj
跆	nvl
瘠	pss
饕	lsm
佚	eqg
淄	ivj
谀	ort
镳	tiu
廿	sfi
偻	epc
沱	ior
袤	ocq
對	kua
诌	oyx
畿	vvg
苯	sff
佻	eqs
繇	ewq
魈	wmw
屌	blm
獗	rsu
鞅	gkg
蹶	nsu
雹	dwc
旯	jyf
洱	iar
哂	ldx
蔗	sus
饨	rax
奘	xh
芍	swo
腴	wrt
現	gmx
汾	itb
顼	gdk
濂	iuu
殒	frl
麝	iwa
鹞	ewy
蚤	bok
坂	heb
忤	yqd
洙	iwt
祗	hta
迤	qcp
眦	mnr
暹	jwp
僮	eik
钺	tgx
嘞	lgx
玳	geg
蛹	kbt
睾	qmh
赁	eek
螭	kpx
瑁	gks
侗	ekf
骛	cqe
宕	odh
堰	hgj
厩	sxv
萋	sdx
帔	mvp
蓁	sgr
杈	fbo
挞	agp
開	kfs
钏	tqc
煊	uof
缮	vuu
夔	utn
燧	uud
孱	bvv
懑	isf
邕	vlc
柩	fgy
耆	hrj
鹄	wly
龛	ydq
餮	frt
鹘	mya
爰	ehb
噻	los
倨	ebd
汜	ick
锃	tlg
璟	gjo
纰	vrr
绡	vmw
鏖	iwj
瞭	mgu
氢	qbf
藜	srw
郢	lgc
妫	cox
栀	fef
岫	jko
谥	out
骧	xol
犄	wga
辇	ggh
魑	wpx
椿	fgj
谩	ojm
伢	ehy
琊	ghc
骅	xer
闩	pfi
颍	rkd
翕	yxx
濠	iod
仞	ebo
玖	gyo
踊	nbt
痿	prc
芑	sbj
檄	feo
帼	mng
撸	aqj
啵	liv
昶	okj
柚	fko
祐	hsl
篑	qlk
陲	ces
亟	vlb
樽	fug
莆	sfu
舶	qeb
蛀	kog
點	nml
棂	fxu
抻	ake
怩	ybr
嚯	ldw
韭	lfi
膘	wdh
酩	grl
忸	ybc
刎	wtm
扪	apn
漳	iij
瑄	gof
仃	ean
佞	esc
饬	rqx
裨	pwd
巽	ccs
黜	nx
徉	rug
纫	vbo
溉	ixv
範	qgv
胛	wkj
卟	lmo
锌	tox
遑	egp
跻	npt
珣	gwj
蒿	sol
岷	jc
魃	wsb
苋	skx
潞	ine
铤	tex
涿	ido
薜	sbl
鲛	qot
睥	mwd
稔	rto
锲	tdb
徜	rns
冼	swq
獐	rij
讧	ofo
氨	qoc
缯	vuj
菀	sor
炅	juo
碜	dvg
戗	tvg
犍	wxa
酊	gan
钠	tkt
铀	tko
羯	ujw
挝	aap
邙	ucj
渚	ihj
胫	wbf
箸	qhj
逖	rup
砥	dta
狒	rvt
荟	sts
汛	ivd
盥	rkm
睚	msh
祚	hqm
烩	uts
氣	qpm
夯	gxk
拮	ahl
驷	xn
蜞	kdj
灏	ijo
發	bvq
徇	rwj
荪	svm
蹴	nom
谯	owu
忾	yqq
祛	hhv
膻	won
黢	nvt
仄	ste
唳	lis
烊	uug
孀	cdf
斫	dej
腚	wof
牍	tdv
秣	rho
榷	fyw
镭	tdj
庾	urt
媾	csk
嫒	cey
谌	odx
啮	lnt
蝼	kpc
闱	pav
逡	vte
篙	qol
問	klv
隍	ceg
蕨	ssu
囵	ntr
橹	fqj
喱	lsk
話	ure
肓	uwy
榈	fpl
绶	vey
罹	myw
槁	fol
裱	phr
荑	sgv
牦	wrm
滓	ioo
腓	wli
秆	rhg
荏	see
斛	yts
給	bye
恫	ykf
纾	vcu
麋	ipm
锟	tjr
诳	org
寮	ogu
驽	cbx
囫	nwt
炷	uog
缙	vau
徕	rfp
弭	var
柑	fss
圜	nmf
撺	apl
魉	wfk
儆	esw
妊	cen
犸	rxm
哓	laq
酶	gqb
當	njt
缢	vut
鲫	qxv
藓	squ
佰	edj
痔	pha
觥	ytm
讓	uol
伉	eoq
怄	ygw
牯	wdg
茀	svt
烜	ufj
轱	hdg
泵	dkv
蝌	kr
绻	vug
呔	lgo
釉	qpk
纥	vqv
翳	gqq
從	rtt
砧	dml
辔	vhv
覺	rww
胰	wgv
蜍	ktf
趿	nvo
鸪	dya
霰	dsw
邊	tpo
诨	oyh
僭	egq
動	wkx
弁	vsj
湎	igi
栉	fsx
蹉	nuf
铂	teb
梏	fwl
鸩	yqy
虺	hkc
疡	pvt
嘬	lja
荞	set
煨	ujg
蛔	knl
焖	upy
祉	hni
魍	wku
桎	fhk
诿	orc
娠	csn
瓯	gwa
殚	fru
镁	tug
胱	wmh
刍	yxl
糅	pcq
亞	fja
岿	jux
唁	lua
笳	qxl
齑	ptl
狎	rkj
鳍	qhr
揆	abf
钹	tsb
侩	ets
帧	mmk
姮	cfj
種	rwk
骈	xus
仟	ewk
柁	for
珲	gyh
蛭	khk
痍	pgv
猢	rdw
俦	eda
镫	tbf
鼹	rbj
悌	yuv
咩	lug
亓	faj
铩	twf
噱	lmd
硌	del
椤	fmr
臉	wrl
脍	wts
炘	uej
淖	imj
汞	fkv
姘	cus
泅	int
铡	tkm
桫	fim
恽	yyh
薏	sij
屙	bca
蚪	ksd
窸	pqp
蒺	spq
觞	ytq
葺	sla
煅	uef
茕	syv
悱	yli
拋	adx
箔	qie
璠	gqp
別	lwm
菅	sob
嶷	jrq
與	rsk
臬	tfv
岬	jkj
舢	qjs
肱	wsv
焙	uil
啖	luu
蜢	kvm
級	bvo
铨	ttg
胺	woc
旻	jpw
雲	dsv
堇	gsi
艽	syf
湟	ieg
瑭	gux
踅	aen
芨	svo
嶂	jij
逶	rcp
钾	tkj
跹	nwp
徭	rew
鹌	gky
笞	qvl
仵	eqd
缛	vsa
椽	fbd
暝	jyj
玠	gtt
囿	nsw
畹	jor
帏	mav
缦	vjm
铣	twq
舂	grj
碘	dks
芫	sfh
铢	twt
塬	hse
氯	qxk
倬	emj
實	obd
颏	odk
篾	qmd
柘	fdh
桉	foc
砒	drr
邶	urc
洌	ifr
颛	jsd
蜮	kgl
骢	xr
柒	iaf
呖	lsx
饴	rvl
圩	hfa
茯	ses
圄	nfc
琚	gbd
钿	tjt
貅	yef
蛎	ksf
嫱	cdu
辂	hel
綦	dbs
笤	qbl
鼬	rbk
苜	smf
茏	sdq
艄	qmw
辚	hpr
伥	eth
骓	xwi
疟	pxl
筌	qtg
屐	brd
猁	rrm
傩	ebw
帶	sfy
貊	ydj
珙	gst
鼐	vmx
獭	rfl
嗞	luv
獾	rsl
洮	iqs
邛	fcj
赅	koi
擤	atj
稗	rwd
竽	qfa
铧	ter
郾	gjc
師	yfm
铆	ttm
滁	ict
陂	cvp
喁	lky
湫	iru
钨	tew
钲	tfn
蕲	suj
噹	lnj
舛	rao
荠	spt
稞	rjf
媪	cjm
悒	ylc
笏	qwt
晷	jem
郗	wsm
宥	osw
葶	soa
愛	eyy
阡	cwk
猗	rga
粕	peb
蚨	kgu
畲	thj
睇	muv
洇	ing
裏	okr
癣	pqu
虢	eam
龍	iwm
內	kru
颎	rud
馏	rtj
髭	hnr
莛	sex
钯	tc
楹	fvb
虻	kuw
苌	sth
聽	agd
躅	nmw
牝	wri
钎	twk
畦	jhh
欤	sfe
桁	fra
腩	wdk
該	uoi
屍	bfr
眬	mdq
張	vha
鸶	vvy
楫	fla
薨	smy
訇	wua
镊	tab
镗	tnh
樗	fdf
苫	sml
罅	wmq
涫	iob
螟	kyj
骝	xtj
連	gpd
蓿	soe
侉	egf
厝	ssj
馐	rub
潍	ivw
兕	khw
黩	ndv
胪	wmb
抟	asx
結	bhl
裝	xho
芪	sta
莳	sja
筇	qfc
猞	rth
砭	dqp
澧	iks
挈	dbt
镞	toq
怼	ba
嬗	con
貔	yrw
杷	fcb
薹	shl
並	ukg
讴	ogw
铬	tel
闼	pgp
歃	wre
輕	gfv
箜	qpf
彀	hfv
雠	wow
揿	ate
荩	sbo
恂	ywj
茴	snl
國	ngl
衽	pen
鲈	qmb
缟	vol
昴	jtm
廪	uon
垓	hoi
奁	ggw
黟	nrr
讦	ohg
葉	shf
铰	tot
氖	qvj
陉	cbf
妯	cko
耄	hrr
踟	nql
镛	tux
鲧	qqb
峄	jba
搦	avs
飨	vqy
鳏	qmk
猡	rmr
痼	pnd
殺	wfq
馕	rdl
枰	fhu
黼	kum
酽	gau
鲇	qml
佤	eaw
妁	cwo
垩	auh
處	meq
锆	twl
鄞	gsc
乩	mlx
幂	yjg
蟊	cqk
垭	hau
萁	sdj
伧	etv
恚	hhy
盱	mfa
矬	qtt
兒	rqr
侪	ept
穑	rdu
極	fvl
煸	uin
砀	dvt
陣	cgc
蚋	kkt
吶	lkr
缁	vvj
麂	iqj
猱	rcq
岈	jhy
掮	aiw
趸	fwn
苣	sgb
裢	php
萸	srt
捭	awd
緊	sbb
雖	lkw
妣	crr
啁	lwh
誰	uwi
莴	slk
缌	vjy
夤	rof
終	bes
镏	ttj
玢	gtb
狯	rts
焐	ufc
莜	sen
魆	wgx
荇	sra
鲠	qfj
楝	ffn
榉	fit
蚝	krm
艨	qsy
棹	fmj
睃	mvt
瀣	imr
東	fjr
骐	xdj
筢	qac
靺	gho
磔	dra
柞	fqm
聃	akh
堞	hhf
蟥	ksk
墀	hbk
薅	scs
呎	lbo
嵯	juf
怿	yba
艟	qik
窳	pqq
蛳	kuf
迨	vlp
犰	ryf
篦	qrw
跶	ngp
橛	fsu
趺	ngu
倥	epf
鸹	rya
瞇	mpp
崃	jfp
記	ubj
芡	sei
請	uhw
耧	dtp
眾	met
钴	tdg
欸	vqe
耒	dti
眙	mvl
缃	vfm
怛	yjf
逄	eap
哏	lvn
沤	igw
荨	sxa
圉	nhu
耋	hrh
雙	wwb
毂	hhc
俳	eli
铱	tor
蓠	spx
薮	spc
峤	jet
珮	gqf
笄	qfs
蹁	nin
缗	vca
秫	rfo
璁	gre
吋	lac
祆	hfg
醪	gxx
郿	bmc
庑	ufd
莼	sva
挹	alc
筮	qft
媸	cxf
阒	pms
怫	yvt
鲔	qsw
許	uqd
疣	pdo
雱	dog
團	nga
褫	pem
轳	hmb
锛	tgd
鲵	qrq
萬	sky
熵	uou
謝	uwa
馑	rgs
眇	mmq
瘆	pvg
電	dkd
塄	hmo
續	bhm
纔	byl
涞	ifp
杼	fcu
沖	iln
崮	jn
岘	jkx
镢	tsu
诂	odg
玦	gbt
氟	qvt
鲮	qht
洄	inl
栊	fdq
郏	guc
孢	vwc
獬	ryt
澶	ion
詈	mua
鳃	qjy
線	bek
讵	ogb
璺	rkf
枋	fog
啭	lhs
鞣	gcq
澌	ide
蜉	kev
耦	dtk
樘	fnh
虛	mxf
跖	ndh
蛉	kto
箪	quj
歡	sll
扦	awk
逋	fpd
孃	col
矇	msy
鲽	qhf
诔	odt
毖	rry
髋	mos
狳	rtf
槎	fuf
铙	taq
嫘	cjb
骟	xix
溘	ihv
牖	tif
蹚	nnh
墒	hou
阋	prq
刈	wmd
谝	oin
悭	yn
總	bre
圪	hqv
轾	hhk
笮	qqm
棰	fes
麸	heg
杓	fwo
衛	rca
砷	dke
辦	oxo
疴	pal
餍	ssy
锱	tvj
寤	oxf
糍	puv
芎	svg
捩	ais
蹼	nku
尻	byf
缡	vpx
鳕	qdx
幛	mij
茑	sya
榫	fwd
茼	skf
鲅	qsb
郜	wlc
樨	fbk
碇	dof
蓍	shr
萘	sgh
炔	ubt
凼	kxg
飧	rys
岢	jal
刿	jrm
谰	opf
蕖	sig
痧	pim
霈	dif
訴	ueo
唵	lgk
钚	tdu
聖	alg
腦	wvr
叆	sve
槲	fyt
亂	ebk
痈	ptn
狷	rlw
漸	ige
酢	gqm
阍	pta
層	buj
準	iwd
傈	edf
渌	ixk
怙	ydg
莪	sqa
視	hmx
吽	lwn
浞	inv
镠	txx
嘚	lrj
昉	jog
盍	hvm
圍	nci
霪	die
赉	fpk
菏	sia
夠	rrw
诹	oab
苴	smi
粳	pfj
惡	fjy
義	uqa
趵	nwo
護	usw
舸	qal
畈	jeb
笊	qek
燠	urp
阊	pjj
鸬	mby
艿	svj
攮	adl
璘	gpr
椟	fdv
菰	svq
氦	qoi
笸	qgl
圮	hbj
佈	esm
髡	hhw
谖	oeh
枳	flt
則	mmd
髫	hbl
暾	jov
訾	nru
確	dyw
趕	djh
缳	vmf
镒	tut
碛	dhk
硖	dgu
斷	vvf
溧	idf
柢	fta
镬	tsw
虼	kqv
帙	mqg
箝	qas
軍	ygc
鋈	iew
锞	tjf
樓	fld
眭	mhh
溱	igr
倆	efm
泮	iua
隰	cjv
郯	uuc
約	bwo
尋	xfl
愀	yru
嘡	lnh
識	uij
墼	gxq
跬	nhh
毀	rhq
醚	gpp
鳜	qsu
恆	yfw
麇	irh
遄	jsp
達	hup
竑	isv
琤	gyx
趱	dwq
黃	ssk
螅	kty
壞	hom
垸	hof
細	bjt
玭	grr
裎	plg
埸	hjw
試	ugf
淚	iis
肽	wgo
顯	jvv
顸	hdk
盉	rmn
褊	pin
帻	mhk
鲟	qxa
瘐	prt
梃	fex
簋	qvm
缵	vwq
屣	brn
缒	vyp
塊	hwu
炻	udh
絲	bbs
焗	ubv
瘿	pkk
锶	tjy
磴	dbf
鼍	llj
跣	nwq
練	bfn
迓	hpd
疖	pxj
閃	kte
鐘	wik
炝	utv
硒	ddx
汔	iqv
蛄	kdg
伛	egw
燹	ddu
绂	vsb
凇	sft
跗	nea
翀	xxl
銀	wvn
綠	bbk
調	uwh
寫	orw
嗉	lhb
盡	xfu
饫	reo
璩	gmd
純	bax
沚	ini
殘	frg
笕	qkx
鲥	qja
煳	udw
褙	pur
嵊	jru
劢	fwx
尥	dwo
隻	wbu
轫	hbo
佾	etw
抺	ahe
鲩	qof
媽	cdm
熘	utj
萏	syr
睏	mnf
響	vqo
剡	uum
喾	iyw
鍊	wfn
麴	dew
砗	dhc
髁	mjf
蚍	krr
阃	pnf
溲	irn
狺	rua
鲢	qhp
傑	era
燒	uhh
疋	vnf
愦	ylk
缑	veb
洫	iqm
員	lmb
蚜	khy
螈	kse
粜	xxp
荸	sdy
踫	nuk
绨	vuv
抔	adu
庋	udb
胝	wta
計	udi
铍	tvp
锔	tbv
蝣	koq
跏	nxl
習	xxe
論	utf
柙	fkj
網	bku
勰	xxx
鸫	amy
罘	mdu
笥	qvf
潲	irm
扃	ikl
皤	eqp
鲱	qli
險	crl
憶	yij
溽	isa
伲	ebr
禮	hks
屬	bkm
狀	xs
痦	pfc
桿	fjh
袢	pua
嘆	lsf
鳎	qjx
滏	itw
廨	uyt
觳	hfy
戢	lag
羅	mbw
郛	evc
買	mmb
蓐	ssa
疠	pfw
锜	tga
業	kut
粝	psf
郇	wjc
鹩	guj
耜	dtb
坼	heo
迴	nlp
陰	cto
鹪	wuy
栌	fmb
埕	hlg
嫠	hes
尜	mgm
洳	icl
廝	ude
埒	hea
墁	hjm
脫	wtl
講	usk
颟	sfk
蹀	nhf
蔟	soq
劬	wlx
誘	urv
飄	dhr
谮	ogq
畀	jaj
紛	btb
镲	tow
蚬	kkx
煩	udm
郫	wdc
嗍	lux
讚	uwq
臜	wwq
阈	pgl
組	bmi
頂	adm
赜	shk
鳐	qew
歲	ndf
狁	rvq
陔	coi
擺	amv
矽	drk
汆	rkv
磲	dig
湜	ijf
呒	lfd
钼	tmf
蝰	kgh
畋	jeh
劁	wum
肫	wax
崦	jgk
瘋	prf
慘	yvv
酹	gea
胼	wus
锑	tuv
稱	rek
暌	jbf
菔	swx
蟻	kuq
旆	oqf
胙	wqm
琍	grm
靸	gvo
畢	jsa
癒	ptf
簡	qkj
碡	dhb
缣	vux
觇	mlk
擔	ays
谠	onq
埽	hxy
補	pfu
丟	gvv
聯	avv
牆	xht
倖	ehu
統	bov
鞬	gxa
芟	sqh
鲷	qwh
踔	nmj
產	psw
蚴	kvx
鲞	ugq
討	uac
紙	bta
囟	rwl
桴	fev
費	vtm
燔	uqp
飑	qww
騙	din
疃	jik
賓	ofm
唑	ltt
幞	mku
琇	grv
溴	its
鲆	qhu
掊	ail
畚	vgj
塵	iht
泖	itm
硗	daq
質	eem
帥	ymv
隈	cjg
碚	dil
劉	twm
怃	yfd
罱	mdk
側	emm
嵫	juv
捽	aot
揮	ayg
採	aef
設	uqh
绱	vns
虮	kqj
醢	gsl
埘	hja
陬	cab
祓	hsb
翚	xxy
羑	uyo
負	ymb
櫻	fmm
锕	tca
砼	dtf
侔	evw
鏡	wij
豬	dhj
偉	eci
擋	anj
牾	wfc
硃	dwt
籴	rpm
杪	fmq
訝	uhy
揠	agj
耪	dto
缧	vjb
鬏	hru
畫	xhj
騎	dga
蓋	shv
诼	odo
敗	meh
議	uuq
蛴	kpt
詩	uha
嗌	lut
嘌	ldh
畎	jsq
楯	fed
脬	wev
萊	sdl
缬	vhl
圖	nld
賞	nmb
谇	oot
哕	ljr
驗	drl
廛	ukt
丏	axv
罵	mdm
氚	qqc
袷	pye
黾	lkd
緣	bbd
铵	toc
躞	nuu
绲	vjr
環	gmf
镉	tfl
诖	ohh
據	amd
柽	fbh
豨	dws
蹤	nrt
骯	moq
禊	hdb
茌	seh
圬	hfs
疔	pan
潔	idb
睜	mex
虿	fwk
铯	tyc
呋	lgu
匦	ghy
圓	nlm
垧	hrn
洧	isw
浯	ifc
跡	npi
桕	frj
惝	yns
臨	sql
憐	ypr
蛞	kre
牤	wuw
薷	sds
嫋	cvs
蚵	kal
爛	ukf
蕻	shs
蒗	sio
蚰	kko
骶	mta
鳔	qdh
圹	huu
焜	ujr
徬	rou
霑	dim
晡	jfu
湔	iuw
鲀	qax
燈	ubf
聞	kar
歸	ynx
島	rjs
篪	qem
甾	vjt
髂	moe
權	fsl
維	bwi
紀	bbj
蘋	snm
裥	ppj
胗	wtt
宮	olr
紮	fxb
枵	fls
笪	qjf
鲼	qds
沩	iox
绁	vhi
腧	wtf
溻	ijx
罾	muj
蛏	kbh
紡	bog
遙	wwp
稜	rht
樑	fib
莊	sxh
蜱	kwd
優	edw
勁	fvf
氆	ruk
爝	uem
爺	twa
鬆	hft
蹟	nhm
钒	tqo
铫	tqs
巖	jl
笾	qxp
踬	ned
楦	fof
曛	jwn
埝	hto
钍	tht
茆	stm
炱	vlu
谂	oto
俠	egt
硭	dsu
際	cwh
栝	fre
馇	rfj
趑	dse
霧	dcq
軟	gei
詭	uys
鳊	qin
屦	brp
玙	gsf
撲	aku
螽	esk
埤	hwd
濕	ijv
莩	sev
膚	mjw
醅	gil
莸	srd
蜩	kwh
導	utp
梿	fhp
寧	oym
蓮	sgp
毪	rvw
氘	qti
卣	mnb
洎	itk
赙	kfa
栳	fhr
煉	ufn
骒	xjf
災	vuo
織	bij
廳	uag
籐	qwu
纏	buk
揸	afj
渫	ihf
婦	cxy
劼	hlx
撐	anh
鬍	hdw
邾	wtc
慮	mjy
紗	bmq
縮	boe
堙	hdh
噍	lwu
喲	lbw
複	pqj
謎	upp
寬	osm
誤	ulf
紋	bpw
喬	elk
鞒	get
瀰	ivf
凱	jfl
灑	ifk
薑	sfj
嗪	lgr
僅	egs
穀	hfr
刭	bfm
钋	tmo
蛘	kug
钕	tcn
損	alm
玗	gfa
攉	adw
氩	qau
黪	nvg
遞	emp
勗	jmx
垡	egh
骀	xvl
缂	vge
锇	tqa
肟	wfs
霨	dbh
財	maq
仡	eqv
籀	qat
蜣	kux
瘰	pjb
讀	uhm
嘗	nrj
砟	dqm
傭	eux
榮	uuy
牂	xug
嵛	jtf
詠	uok
孫	vqb
瓿	ila
槔	feg
瘛	pdb
煺	uvp
礦	dus
忭	yom
垌	hkf
蛲	kaq
嘧	loy
蟛	khl
辋	hku
鬚	htd
龐	uiw
獴	rsy
儀	euq
镘	tjm
詞	uvf
氾	ivi
鞴	gsq
殪	frh
兇	wxq
胍	wqu
唼	lic
穩	ref
躍	nxx
捯	ahm
職	aij
烀	uqu
碼	ddm
壯	xhf
檔	fnj
硐	dkf
灣	iub
紹	bbl
檎	ftp
囧	ntk
齊	oun
戽	isd
廁	umm
盜	iem
氡	qes
苘	skl
鳴	lro
諸	uhj
枧	fkx
麵	deg
瑯	gox
尷	dsq
軀	wgl
桤	fjb
積	rhm
柺	flx
鑑	wsq
鲣	qnb
铒	tar
餓	yqa
湲	ieh
啟	ile
帳	mha
酐	ghg
痲	psi
坫	hml
夬	bte
铪	tye
贶	klq
胂	wke
閻	kyr
贏	umb
肅	xtx
疬	psx
橋	fel
涠	ina
鹇	pfy
掃	axy
繃	bjw
簽	qrl
眵	mrr
珧	gqs
靿	gvx
苈	ssx
翹	hhh
脈	wer
籃	qsq
賺	mux
坭	hbr
钌	tvl
撥	abv
饹	rel
厍	shc
編	bin
嵝	jpc
躐	nvn
諒	uom
儘	exf
縱	brt
訓	uqc
綁	bdc
跐	nnr
甦	fjw
館	yob
砘	dax
捨	ath
飲	yei
埯	hgk
澤	imh
彎	ubb
嬌	cel
琯	gob
惱	yvr
暈	jyg
舄	rwu
硇	drw
堍	hyl
姪	chk
舊	swr
爐	umj
夼	gqc
駛	dlw
兗	otl
皺	wxw
虧	mwf
胨	wam
拤	akm
臟	wsg
饸	rye
迕	qdp
砜	dqw
淠	ija
違	cpd
圊	nhw
鲚	qpt
禍	hna
菪	sod
輛	gfm
撚	aws
腈	whw
彌	vft
箦	qhk
滗	iqr
詛	umi
駕	xld
仉	eqj
縠	hfb
犏	win
絶	byc
奧	rqp
镧	tpf
獲	rsw
綑	bn
鋒	wed
罈	wdj
钫	tog
坌	tbh
暢	kjf
梱	fnf
臺	hly
潛	igq
褟	pjx
侶	elr
縫	bed
铋	tyq
悅	ytl
簷	qys
鼯	rbf
勳	wnx
廂	ufm
胬	cbk
澉	iva
肼	wst
枨	fth
鹛	bmy
闖	kdm
棁	ful
窮	pwv
捃	axq
鍾	wwk
罨	mgk
燜	uky
俬	erv
療	pgu
訊	uvd
跞	ntm
媭	tdk
酤	gdg
恓	ydx
蒟	siw
罰	mum
闊	kir
巯	bfo
绗	vra
謹	ugs
罽	msu
閑	kfv
韁	gfj
蛸	kmw
廟	udj
崚	jht
眍	mgw
杻	fbc
蔭	sct
撿	arl
渾	iyg
搋	aem
緻	bhe
綿	bem
墳	hds
蝻	kdk
荬	svs
眊	mrm
兌	tlq
蠅	kjm
嚕	ltj
泐	icx
瘵	pwh
運	ygp
揹	aur
迮	qmp
挾	agt
窺	pgm
鎮	wdm
騷	dbo
嬰	mmc
嬝	cro
跼	nbv
瑪	gdm
炤	ubl
踺	nxa
嗚	lyw
窩	pna
飽	ywc
賀	xlm
鶉	ovr
詢	uwj
譜	uuk
殼	hfq
脣	swy
竄	prb
攤	asf
赇	kfk
錶	whr
睪	mhu
繩	bjm
儲	euh
併	eus
誅	uwt
頁	dmb
閱	ktl
慶	ivy
納	bkt
摟	ald
評	uhu
爍	uev
鱗	tpr
镓	tod
攝	aaa
糾	bxg
鬱	fwf
馳	dcy
蝕	ykc
賦	mfg
謔	umx
黨	nne
縛	bfa
攴	mbu
鳢	qks
饒	yhh
鳙	qux
燻	uwn
螵	kdh
闢	kbl
億	eij
铑	thr
鍋	wna
菴	sgk
償	enm
稅	rtl
綻	bof
壇	hon
噓	lmx
狹	rgt
飼	yvf
購	msk
嘖	lhm
誕	uqn
鏈	wgp
匯	giw
闔	khv
曬	jfk
輔	gfu
擬	arq
審	oqp
蔣	sxw
筍	qwj
絡	bel
骣	xbv
邁	skp
侷	ebv
疊	jjj
軌	gyf
賊	mgs
彙	byj
搗	arj
犋	wmt
蘇	str
耠	dty
篛	qvs
鳓	qgx
嚆	lso
鴦	kgr
巘	jmf
鑰	wyl
闋	kbf
萜	smm
穌	trh
蔥	sre
朧	wiw
艙	qto
賢	sbm
轅	ghl
柈	fua
曠	jus
慍	ynt
纖	btt
窪	pih
謊	usu
鹹	kdf
漲	ivh
覷	mkm
債	ehm
粞	pdx
矓	miw
韻	ijl
駭	doi
懇	yvy
噠	lhu
膦	wpr
燦	umr
獰	roy
篤	qdm
嚨	liw
铟	tng
漁	ity
醃	ggk
寵	oiw
攔	akf
嬤	cpv
襯	pif
鈕	wbc
铌	tbr
嘩	lsh
餅	yus
狽	rmb
屆	bhx
挦	axa
辮	obo
釀	gol
僱	eiw
屜	brh
絨	bgs
嵎	jky
緞	bef
莖	sfv
衆	qme
镩	tpl
賠	mil
蘿	smb
燼	uxf
蝽	kgj
錘	wes
愜	ygg
猙	rex
铼	tfp
瑋	gci
嵖	jfj
縷	bld
籠	qiw
枴	flb
譯	umh
釘	wan
犧	wur
淵	itx
脲	wbk
紈	byo
姦	ccc
蘊	sbn
牁	xal
蠶	gqg
嵐	jrf
滪	icd
輟	gbb
鴉	hro
譎	ucq
樸	fku
禪	hll
槓	ffm
盃	dmn
氈	onl
脹	wha
穢	rnd
鼢	rbt
釣	wwo
韓	djc
膠	wxx
詐	uqm
鍛	wef
梟	rfv
囑	lbk
燐	upr
蝦	kbs
塆	hpv
綢	bwh
趨	dwx
壺	hyj
崗	jku
絞	bot
緝	bla
瑣	gmm
釵	wbo
齪	mnv
盞	ggm
僕	eku
齬	mfc
鵬	wwr
絆	bua
錐	wwi
贖	mhm
嘔	lgl
攪	arw
緬	bgi
繚	bgu
鐺	wnj
娛	clx
脒	wpm
氳	qnt
峽	jgt
鞡	gai
靰	ghw
鹐	yry
髏	mld
廚	uhl
颯	irf
潟	irw
曇	jds
妝	xcn
欽	wei
鴨	kro
镵	tyl
鏟	wiq
喹	lgh
缽	wff
綣	bug
遷	dgc
姍	cnc
鞦	gru
躪	nsk
綺	bga
稃	rev
薦	sis
齣	mwl
輯	gla
鶴	ywr
矚	mbk
馴	dqc
靂	dsr
揀	afn
繪	btf
繡	bxt
綽	bmj
絢	bwj
媼	cnt
椪	fuk
闌	kfn
幀	mmm
畝	ojy
蘆	smj
憫	ykp
卹	qmx
餚	yws
壎	hwn
譁	ush
漣	igp
燭	umw
噥	lks
隕	clm
虜	mjx
澱	ibs
瓊	gyk
靄	duj
瀝	isr
囁	laa
馱	dgd
隸	fhx
紐	bbc
鹽	sqk
繭	skn
譴	ulk
铷	tcl
廠	une
綜	boh
牀	xfv
絹	blw
錦	wem
鬨	nst
諏	uab
裊	ror
懺	ytt
嶼	jrs
籌	qhv
摳	agl
頃	rdm
鉅	wgb
铈	tom
鵑	lwr
紳	bke
褻	oht
睞	mdl
韌	cbo
踐	ngg
陝	cgr
螋	krn
糰	png
襪	psm
搾	apq
驃	ddh
欖	fsq
縊	but
僞	eew
鴿	yro
銜	rwa
腎	sbw
斕	pkf
慚	yge
柵	fnc
暘	jjf
齶	mll
諱	uci
鋸	wbd
誠	udv
貿	tmb
蠔	kod
澗	ikj
滌	ien
謅	uwx
瀆	ihm
匜	gcy
鈞	wws
礫	dev
輻	gfl
繾	blk
緘	bdf
竇	phm
絝	bgf
繳	beo
駑	cbd
輓	gyl
輿	rgf
鴛	rvr
纴	ven
誥	uwl
儂	eks
藪	sld
躱	wvf
鏤	wld
鉗	wss
閘	kkj
驢	dmj
螻	kld
驛	dmh
莢	sgt
皚	ejf
貲	nrm
濘	ioy
緯	bci
賄	msw
繹	bmh
餌	yar
樺	fsh
襠	pnj
誨	uqb
訐	uhg
朶	vfv
誒	uvq
鋤	wmx
臚	wmj
篩	qyf
鍬	wru
鉛	wql
犢	whm
鑣	wiu
攬	asq
嚶	lmm
嶄	jge
餉	yrn
擰	aoy
覈	deo
軔	gbo
縐	bwx
僑	eel
鲴	qnd
癘	psk
軸	gko
鈉	wkt
銻	wuv
奬	xwa
龕	yiw
鴆	yqr
餡	yyr
嶇	jgl
齟	mmi
韜	cer
嫻	ckf
貳	gsm
鷂	ewr
卽	erx
儉	erl
磯	dvv
鳶	gro
賁	dsm
輒	gax
檸	foy
蓽	sjs
籲	qyl
轡	bgb
矯	qel
萵	sna
訃	umo
誣	uft
魷	tdo
踒	nrc
貸	egm
餾	ytj
疇	jhv
愾	yqp
甽	jqc
鹼	krl
蝸	kna
嶗	juu
懍	yon
闈	kci
閏	kgn
櫛	fqx
奩	ggl
韃	ghu
壙	hus
琺	gih
醞	gnt
鸻	ray
錚	wyx
颶	rmt
諍	uyx
簫	qxt
藺	skw
蘚	stu
廡	uqs
铻	tfc
襖	prp
鈾	wko
鎢	wyw
圇	ntf
鉻	wel
跥	nvf
玅	ovm
賑	msn
齦	mvn
躊	nhv
躥	npr
緇	bvj
紼	bvt
縟	bsa
紉	bbo
繮	bfj
綾	bht
綰	bob
鴣	dro
旣	erg
櫝	fhm
儔	ehv
騾	djb
驪	dfk
讒	uyl
䏝	wsx
釧	wqc
鋅	wox
鏝	wjm
鏍	wjb
鐃	whh
鉑	web
鈣	waf
詮	utg
鰱	tgp
謨	usj
訖	uqv
諺	uiq
詁	udg
䥽	txb
䦃	tsh
鱸	tmj
銓	wtg
錳	wvm
銖	wwt
飩	yax
㤘	yyx
墾	yvh
饈	yub
飭	yqx
奐	ykt
飪	yen
餒	yec
牘	thm
鱷	tgl
縑	bux
傯	ere
驥	dur
硯	dmx
麪	dea
嬋	cll
隴	ciw
嫗	cgl
纜	bsq
蕪	sqs
紇	bqv
締	bou
縲	bjb
綏	bec
鷥	bbr
紂	bac
捫	akn
㧟	aig
櫚	fkl
璦	gey
軾	ggf
輊	ghk
稈	rjh
鼴	rbg
簍	qld
糉	pwx
襤	psq
褸	pld
齲	mqk
貯	moa
螄	kyf
崢	jex
塢	hyw
壢	hsr
琿	gyg
軋	gxi
輜	gvj
鵪	gkr
的	ewod
一	fii
了	vll
是	jfnf
不	duu
我	qagg
在	snht
人	tee
有	swyo
这	ppdw
他	ecye
来	fpmi
个	tnse
你	eyma
说	oulq
上	kss
到	hmdk
就	omdo
着	umfg
大	gdd
们	epne
道	utpd
那	vacj
么	qvvp
也	cyy
地	hcyt
子	vkk
下	akk
出	xxgg
时	jacr
看	tmfu
要	dcnx
她	ccyn
中	lnsv
没	iqhs
然	wsuo
里	kkk
为	oxod
过	apdc
自	tkk
好	cvkn
得	rjfa
去	hvvt
可	alvn
会	tsvv
天	fgdi
还	dpdu
心	yii
后	eflv
以	xote
小	maa
都	hjcj
和	rlvh
对	bacu
想	fmyi
能	vwrr
起	dbjk
之	pee
手	tuu
而	srr
只	ltiv
生	wgg
什	edie
身	wmm
头	sgdi
样	fugv
事	alxl
多	rrkk
己	bjj
家	odsb
面	gii
知	qlvi
开	fsji
如	clvn
无	fdoi
现	gkxn
很	rvnc
点	mluo
前	uwmd
发	xbod
经	vbfo
情	yhwy
把	acbo
老	hrit
些	nrsi
话	orea
已	bii
又	buu
声	hbhf
意	ijyi
于	faui
回	nlvw
笑	qeok
所	ieje
但	ejfi
眼	mvnf
成	dviw
方	ogg
年	qaok
见	kxx
当	mxla
女	cnn
真	dmti
两	fktt
力	xkk
气	qqq
从	ttee
用	tnn
长	thh
动	svxk
间	pjrn
国	ngod
走	dkk
让	oksa
被	pvpy
给	vyes
正	fnii
问	plvn
打	aano
明	jwyr
儿	qrr
法	ihvv
才	aqpu
几	qjj
行	rahc
三	faa
定	ofnf
此	nrii
进	stpd
再	gkfn
种	rlns
将	urac
实	osgd
同	kflv
最	jabu
本	ffiv
向	rnn
分	tbdi
十	dii
学	iyvk
高	oll
第	qvnq
感	dfly
怎	qmyi
神	hkes
听	lejv
边	xpdk
作	eqmo
其	djj
吧	lcbv
却	hvxj
口	lvv
觉	iykx
啊	lcal
因	ngdw
白	ebb
次	seii
军	yhcm
做	edeh
外	rmok
门	pnn
光	mhwa
风	qwlj
主	ognd
住	eogn
果	jfvr
与	sfik
全	tgne
二	sii
候	enbq
公	tvvi
相	fmfv
吗	lxmv
等	qhac
别	lxmd
色	ycbm
死	frri
张	vthg
部	ilcj
太	godd
日	jrr
少	mqpa
战	mlgg
理	gkkn
直	dmii
重	wkkk
王	gnn
像	eyld
脸	wtfi
比	rrii
快	ybte
何	ealv
水	kvv
名	rlvk
体	effi
呢	lbri
东	amai
叫	lxgv
西	dxx
应	uisu
便	efjw
放	oehg
马	xmm
难	bwiu
轻	hbfo
更	fjwl
美	ugdg
位	eide
关	ugde
机	fqjv
接	aicn
先	wqrn
文	pww
处	emoh
并	usje
望	uwgn
常	nmvs
完	ofhw
四	nqrw
飞	vsii
师	ufmv
者	hjrt
安	ocnb
清	ihwy
刚	kwmd
跟	nvnv
月	wyy
信	euae
山	jss
爱	eysb
内	ktef
龙	dqpo
空	pfox
带	symv
找	aggo
原	sema
入	ruu
李	fvkv
连	hpdc
吃	lqvi
场	hvto
平	hueg
思	jyit
林	ffvv
变	pbui
使	eflw
由	koo
受	eybu
亲	ifvd
命	yxje
目	mff
强	vlkc
男	jxkt
任	eene
该	ooia
路	nelv
车	hcc
今	tovi
海	iqbm
加	xlvk
远	fhpd
活	ires
特	whac
解	ytbw
电	kdd
世	hii
性	ywgi
表	hryf
许	oqdi
它	orib
立	idd
黑	nee
金	wjj
红	vfos
花	seri
转	hsxo
总	ulyi
算	qmsj
城	hdvi
队	ctej
孩	voik
反	ebuj
工	foo
始	cvlv
满	isft
新	ifej
兵	efti
物	wwto
离	pxkv
非	lii
虽	lkcv
云	svvi
似	exot
万	fwyi
至	hkk
干	hgg
通	btpd
认	otea
失	qgup
火	uoo
哥	alal
士	hff
五	fcii
惊	yoma
魔	pwua
竟	ijqr
姐	cmin
乎	quau
剑	tfim
往	rogn
量	jfkk
早	jdd
结	vhlv
怕	yebi
流	iovq
突	psqx
坐	ttht
斯	dejj
音	ijrd
紧	nbbs
指	arjr
拉	aido
杀	wfvl
半	uaoe
记	obja
且	mii
利	rmdh
合	yee
倒	ehmd
书	vvno
度	usfb
微	rfqj
步	nmai
教	hveh
喜	hlul
越	dgxi
影	jomt
谁	owia
冷	stob
深	iytf
告	wlvn
落	siel
象	ylds
容	ptlv
怪	ybht
传	esxo
钱	tfgg
提	ajfn
言	uaa
随	cswp
每	qbmk
双	bbuu
服	wxbu
击	axgo
武	fgni
哪	lvac
数	pceh
站	imlv
奇	galv
房	ioge
管	qobb
灵	xuol
刻	omdi
题	jfnk
衣	oryb
周	whlv
静	hwyv
伤	eqxk
百	djrh
拿	ytue
妈	cxmn
办	xtik
星	jwgr
化	erie
功	fxko
绝	vycb
系	qbsp
般	qqho
必	yqpi
业	kgg
尔	ymam
件	ewne
血	qmnp
代	egye
精	phwy
弟	uvnq
终	vesi
近	epdj
条	efvh
青	hwyf
界	jtti
司	vflv
整	flen
欢	beiu
字	ovkb
晚	jylq
民	caik
帮	dcmv
切	abdi
即	xvxj
忙	yuwi
交	otwl
或	glfi
暗	jijr
夫	guu
员	lkbv
根	fvnv
石	dhh
哈	lyev
夜	oero
父	twli
制	wkmd
友	sbuo
阿	calv
息	tyik
冲	slns
酒	igos
保	elfv
片	tpp
形	fsto
阵	chcj
南	dkud
决	sbte
请	ohwy
各	elvh
报	axbu
兴	itis
阳	cjrj
急	yxyi
语	ofcl
令	tobu
错	tsjr
及	vodj
刘	pmdw
极	fvod
识	olti
备	ejth
慢	yjmb
雪	dxly
苦	sdgj
若	sslv
领	tobk
收	xehg
底	utao
尽	bosi
准	swii
华	erdi
答	qyek
众	ttte
千	wkk
消	imwy
视	hkxs
罗	mrkw
敢	vaeh
留	tjtm
克	dqrg
乐	tmam
够	wlrr
跑	nwck
显	jkgr
嘴	lnrt
官	obbu
断	pxej
未	hee
势	ayox
句	wlvy
求	fkod
计	odia
论	otri
达	gpdd
则	kmdb
害	odlv
八	tii
单	ujdi
久	yodm
脚	whvx
德	rdmy
元	fhwi
脑	wpxg
楚	ffvn
雨	dyy
睛	mhwy
响	lrnv
刀	bdd
确	dytn
玉	godn
沉	iyqj
北	urie
格	felv
停	eoan
陈	cama
市	omvb
朝	djwy
喝	ljwx
族	oqqi
江	ifos
团	naqp
母	bmm
章	ijdd
装	uhor
亮	oqjl
客	oelv
照	jblu
乱	rxie
易	jwto
足	nvv
依	eory
黄	skti
修	enet
破	dvph
台	vlvv
球	gfko
呀	lhyv
院	cofh
送	ugpd
包	wcky
义	owld
诉	oeod
攻	feho
丝	vvss
围	navi
玩	gfhw
待	rhac
复	qjeh
况	slqr
楼	fpcn
丽	fkkf
痛	pbtn
梦	ffrk
呼	lqua
摇	aewo
期	dwyj
英	skgd
低	etao
帝	ouym
兄	lqrv
背	urwy
持	ahac
爷	twxj
皇	egnb
七	aii
六	otib
穿	phyx
杨	fvto
政	fneh
运	svpd
居	bdgh
叶	ldiv
热	ayou
校	fotw
谢	owac
曾	ujuj
古	dgg
细	vjts
产	iqpd
睡	mesj
希	wsmv
速	flpd
室	ohkb
旁	ouyo
另	lxkv
怀	ydui
露	dnel
异	csjk
写	ysfi
鬼	wuu
娘	covn
取	abur
式	gfoy
除	ctff
级	vvod
考	hskt
建	xaxn
愿	semy
招	ablv
饭	rebu
布	smvo
续	vdvg
程	rlgn
首	utke
观	bkxu
朋	wwyy
务	exkh
掉	amjd
赶	dhgk
忽	wtyi
注	iogn
术	fodv
甚	dxij
差	ufog
呵	lalv
展	bsgf
争	yxvi
品	lllv
兰	usie
宝	ogod
香	rjrh
斗	sdii
故	dehg
雷	djty
念	tovy
段	efqh
顿	axdk
角	ytnm
疑	rqbn
护	aieo
闪	pten
木	fvv
需	dsry
调	owhl
类	pgdm
妹	chen
爸	twcb
线	vfgg
左	sfoo
游	ioqv
派	iery
谈	ouuo
激	ieoe
冰	skvi
敌	rehe
跳	nqss
支	dbui
约	vwod
巴	cbb
您	eymy
顾	svdk
肯	nwyi
醒	gjwg
铁	tqgu
抱	awck
淡	iuuo
造	wlpd
伙	euoe
资	sekb
群	xqlu
集	wfvi
联	augd
商	oukl
号	lskv
节	sxjj
讲	osti
掌	ntus
赵	dwlk
密	oyqj
九	yff
病	pfkt
卫	xfij
米	pmm
威	dfcn
继	vpxi
渐	ihej
统	vovq
追	ypdd
亚	auej
简	qpjr
练	vavt
基	dhtj
选	wqpd
推	awio
改	behj
退	vpdn
味	lhev
份	etbd
举	itao
示	hss
忍	boyi
历	sxkh
器	llsl
恐	fqoy
引	vnsg
试	ogfo
皮	vpp
习	xii
靠	wlli
导	cack
存	snvk
莫	sjgd
志	hyif
区	gwlf
汉	ibus
右	slvo
严	auqp
态	goyi
买	vsgd
幸	hudi
社	hhts
佛	evti
议	oowl
树	fbac
止	nii
块	hbte
守	oacb
毛	rmm
挥	ayhc
胡	dwyg
散	sweh
板	febu
仅	ebue
隐	cyxy
怒	cbyi
床	ufvu
苏	sxti
料	psdi
股	wqhy
局	bvlv
班	gugn
图	nesi
岁	jrks
礼	hxis
独	rkcq
初	pbdy
福	hflj
顺	qdkb
狂	rgnq
默	nsqe
巨	gbuf
既	xvgq
松	ftvv
证	ofni
烈	frmu
否	dlvu
恶	auyi
治	ivlv
缓	vehb
排	alio
费	vtkb
拍	aebo
耳	arr
医	gqif
寒	osts
哭	llsq
温	ijmn
府	ueac
担	ajfi
称	ryma
余	tffv
钟	tlns
泪	imfs
烟	ungd
仍	evje
具	mtii
忘	uyiw
恩	ngyi
毕	rrdi
警	swlu
蓝	snqm
宫	ollv
吸	lvod
陆	caxg
究	pyfx
抓	aeko
压	shod
沙	imqp
救	fkoe
呆	lfvv
河	ialv
迷	ppdm
枪	ftvi
组	vmis
权	fbuv
叹	lbuv
孙	vmak
卷	ugvi
查	fjfi
毫	orml
春	gjru
察	owhs
圣	bhtu
草	sjdj
较	hotw
胜	wwgy
遇	kpdy
充	ovqr
史	lwlv
堂	nhts
防	cogj
据	abdg
猛	rvmn
骑	xgal
土	htt
卡	kmos
助	mxki
京	omal
银	tvnj
贵	lkkb
永	okvd
质	edkb
屋	bhkh
须	tdkb
副	fljm
换	aykg
刺	fkmd
属	bqkk
闻	parn
境	hijq
禁	ffhs
阴	cwyj
共	stij
负	ykbm
弄	gsjn
翻	qpjx
虎	muu
层	bsvv
喊	ldfl
逃	qssp
晓	jaqh
座	utth
雅	hwiy
参	vgto
射	wacm
婚	ctaj
险	ctfi
君	xqlv
划	gmdg
坚	nbht
价	etti
柔	cqfv
超	dblv
扬	avto
科	rsdi
按	aocn
狠	rvnq
野	kcuk
秦	grhu
秘	ryqp
熟	ovyu
置	mdmi
仙	ejse
模	fsjg
伸	ekee
波	ivps
肉	ktte
假	ebsb
齐	ptiw
舞	qsfa
脱	wulq
广	uuu
姑	cdgn
麻	paa
投	aqho
顶	adkb
致	hehk
责	hkbf
景	joma
营	syll
维	vwis
设	oqha
坏	hdut
啦	laid
秀	rvjh
败	kehb
眉	bmfh
州	iqcs
药	svwo
承	vkfa
案	ocfv
狼	rovn
专	sxod
偷	etfm
画	fjxg
吴	lfgd
店	umlv
哦	lqag
弹	vujd
食	yss
欲	ttle
抬	avlv
标	fhsv
秋	ruoh
厉	sfwy
良	ovnd
际	chsj
状	usqe
烦	udkb
午	qdik
摆	amhv
戏	bggu
桌	mjfv
船	qqlv
短	qflu
村	facv
某	ssfv
摸	asjg
付	eace
演	ioft
规	gkxu
萧	sxtt
封	hhac
握	abhk
田	jtt
唐	uxlv
藏	sgxs
震	dsny
混	ijrr
虚	mkgu
透	rvpd
纪	vbjs
凌	shte
休	efve
嘛	lpav
梅	fqbm
紫	nrbs
歌	alae
临	nqjr
毒	hbmf
宗	ohsb
著	shjr
索	dybs
印	tfxj
寻	xacl
湖	idwy
劲	bfxk
职	alti
技	adbu
恨	yvni
婆	ivcn
杰	fuov
羽	xxii
咱	ltkv
素	hbsf
凡	qodj
值	edmi
飘	dhqw
养	ugti
嘿	lnev
普	ukjr
宁	oanb
吓	lakv
兽	ujfl
夏	dmeh
读	odvg
街	rhha
牛	wnn
仿	eoge
胸	wwwx
浪	iovn
富	oflj
尚	nss
宇	ofau
骨	mgg
智	qljr
纷	vtbd
升	qsjp
叔	kmbu
善	uulv
弱	vsvs
架	xlfv
卖	dvsg
袋	egor
网	kwwl
朱	wtin
骂	llxm
雄	svwi
赛	ostk
略	jelv
杯	fduv
施	oqcy
墙	hdul
环	gdun
罪	mliw
牙	hyy
窗	preh
柳	ftmv
厅	sanh
搞	aolo
端	ijsr
洞	ikfl
适	rpde
拥	atno
释	qpba
洋	iugs
肩	iwye
魂	svwu
闹	pomv
蒙	syfd
洗	iwqr
灯	uano
借	esjr
伯	eebe
免	ylqr
菜	sefv
验	xtfi
凤	qbuj
鱼	qyy
徐	rtff
型	fsmh
娜	cvac
暴	jstk
亡	uww
讨	oaca
辈	lhci
懂	yswk
腿	wvpd
灭	fuoi
妙	cmqp
效	otwe
危	ysvi
优	edoe
盘	qmno
套	ghad
丁	ann
趣	dabu
妖	ceon
束	flvv
杂	yfvf
诗	ohac
迎	txpd
舍	thlv
旧	njrs
彩	efto
委	rcnh
挂	ahht
笔	qrmk
狗	rwlv
鲜	qugy
纸	vtai
抗	aoqj
探	aytf
韩	djav
尼	brih
控	apfo
惜	ysjr
珠	gwti
抽	akoo
创	tvmd
归	uxle
挺	aexn
奋	gjtd
陪	cilv
硬	dfjw
避	blop
园	nfhw
托	aqai
训	oqca
勇	btxk
聊	atmr
奶	cvjn
庄	uhtu
奔	gdsj
镇	tdmt
拳	ugtu
采	efvk
研	dfsj
配	gbjo
介	ttie
尊	ugac
冒	ksmf
虑	myiu
敬	swle
丹	woby
舒	thlc
蛋	vnkc
哼	lovl
宋	ofvb
济	ipti
妇	cxln
箭	quwm
择	abao
犯	rviq
欣	eeij
甲	kjj
欧	gwei
课	ojfv
扑	amoo
菲	slij
燕	sflu
曲	ksjf
躲	wqfv
玄	ovob
幻	vvio
茶	stfv
折	aejo
伊	exqp
傻	erwe
姓	cwgn
源	isem
洛	ielv
遍	inpd
臣	scc
弃	ovsj
犹	rdoq
占	mlvo
漂	idhs
挑	aqss
获	srsq
绿	vxkv
峰	jedn
俊	evte
疯	pqwl
列	frmd
森	fffv
妻	dxcn
恋	pyii
误	olfg
拜	tfdn
伟	eavi
移	rrrk
纳	vkte
党	nqrs
罢	mhvv
腰	wdcn
巧	fsko
孤	vquk
闭	paqp
圆	nlkb
碰	dukg
镜	tijq
软	heic
厚	sjvk
累	jbst
昨	jqmo
幽	jvvo
悲	lyii
丈	sodo
牌	twdi
降	ceao
颜	iqtk
劳	syxk
偏	einc
省	mqmf
糊	pdwy
馆	robb
烧	uaqh
谓	ojwy
财	kaqp
舰	qkxo
汗	ihgs
奈	ghsd
操	allf
迹	ppdi
尸	bhh
悄	ymwy
残	frfg
尖	mgda
鲁	qjry
锋	tedn
圈	nugv
油	ikos
俩	efkt
项	fdkb
撞	aikk
瞬	meya
忆	yvii
盖	umng
尤	doo
徒	rdkc
乡	vqps
概	fxvq
户	iee
荡	sivt
艺	svij
增	hujj
祖	hmis
困	nfvw
殿	bstq
迅	vdpd
横	fskt
范	sivi
律	rxao
番	qpjt
企	tnie
惨	yvgt
限	cvnj
聚	abes
含	tovl
凭	eeqj
剧	bdmd
碎	dotd
躺	wnsm
缘	vbds
凉	soma
腾	wugx
织	vlti
抢	atvi
预	cdkb
沈	iyqr
替	ggjr
孔	vxik
批	arri
康	uxkv
惑	glfy
唯	lwiv
率	ovsd
惯	ybdk
登	bflu
互	fbmi
盯	manf
稍	rmwy
宣	ofjf
唱	ljjr
诚	odvi
剩	rurm
咬	lotw
育	ovwy
诸	ohjr
触	ytkc
晨	jsnr
策	qfkf
疼	pesi
漫	ijmb
材	faqp
补	pmoy
私	rvvh
吐	lhtv
纯	vaxg
艾	swlj
贝	kbb
谷	ttlv
庭	uexn
挡	amxl
晃	jmhw
吉	hlvf
吹	leiv
仔	evke
仇	eyfe
凝	srqn
鼓	hlub
农	yrym
席	usfm
征	rfni
帅	umve
附	ceac
缺	wbte
塞	osth
豪	odsl
亦	pii
杜	fhtv
努	cbxk
判	uamd
谋	ossf
胆	wjfi
尘	mhta
扎	axio
滚	iotr
闷	pyin
迟	bopd
稳	ryxy
翼	xxjt
诺	ossl
闲	pfvn
灰	suoo
朵	qfvj
盛	dvmn
梁	ibtf
晶	jjjr
餐	mrby
爆	ujsk
伦	etri
娇	ceti
侧	ekmd
愣	ymog
鼻	tjaj
轮	htri
昏	tajr
抖	asdi
陷	cyrj
敏	qbeh
词	ovfl
慌	ysuq
愤	ydsk
怜	ytob
颤	onlk
阶	ctti
苍	stvi
距	ngbu
郑	ugcj
川	qcc
扫	axlo
逼	fljp
县	mvvi
忧	ydoi
童	ikkd
执	ayod
丢	evvn
荣	syfv
臂	blow
逐	dpds
傲	ehwe
戴	dgjt
芒	suwj
庆	ugdu
伴	euao
袭	dqor
供	esti
积	rlti
测	ikmd
遥	ewpd
阻	cmij
例	efrm
睁	myxv
岛	yjsa
遗	lkkp
瞪	mbfu
慕	sjgo
皱	yxvp
博	dfac
幕	sjgm
猜	rhwy
益	utmn
净	syxv
泽	ibao
炼	uavt
监	nqmn
鸡	byau
珍	gtto
伏	esqe
绍	vblv
曹	sjjr
爬	ecbk
丫	unse
炸	uqmo
壁	bloh
涌	ibtn
凶	wxgl
郎	oxvc
宿	oedj
怨	rvyi
醉	gotd
拼	ausj
迫	epdb
革	gee
瞧	mwuo
奥	rpgd
输	htfm
莉	srmd
忠	lnyi
颗	jfdk
嗯	lngy
佳	ehht
旅	oqry
仁	esie
鸟	yaa
骗	xinc
浩	iwlv
塔	hsye
胖	wuao
绪	vhjr
枫	fqwl
拔	asbo
赞	wqwk
炮	uwck
傅	efac
凯	jbqj
邪	hcjy
芳	sogj
浑	iyhc
夺	gacd
宽	oskx
堆	hwit
裂	frmr
遭	sjjp
赤	htti
旋	oqvn
扭	abco
洁	ihlv
浮	ievk
悉	qpyi
擦	aowh
慧	ddxy
典	ksti
赏	nkbs
匆	wtod
评	ohue
纵	vtte
莲	shpd
雾	dexk
乌	eww
跃	neov
壮	uhfe
贴	kmlv
丰	dnn
隔	cfln
健	exax
辛	oxx
抵	atao
竹	qkk
彻	rabd
摩	ptua
轰	hbbu
编	vinc
肚	whty
插	awrj
磨	pdha
哎	lswl
御	rqfx
耐	sacr
惧	ymti
氏	taim
辉	mhyh
扶	aguo
恢	ysuo
貌	yeqr
额	oelk
述	fopd
票	dhsx
录	xkvl
拖	aqcy
膀	wouo
鹰	uewy
孟	vmnk
递	uvnp
瑞	gjsr
唇	slvn
暂	hejr
货	erkb
琴	ggtv
踪	nohs
码	dxmh
慰	bhay
蛇	kori
玲	gtob
晕	jyhc
损	alkb
轩	hhgc
粗	pmim
掩	agkd
屁	brri
悠	eney
仰	etxj
零	dtob
盟	jwmn
途	tffp
贼	kgso
洪	isti
悟	yfcl
固	ndgw
讶	ohya
冬	esih
滑	imgs
甜	rssi
郁	swcj
琳	gffv
辆	hfkt
乃	vjj
猪	rhjr
暖	jehb
妮	cbri
挣	ayxv
旦	jfir
估	edge
坦	hjfi
甘	ssij
佩	eqfm
莱	sfpm
享	ovkl
吼	lvxi
构	fwvv
粉	ptbd
萨	sciq
吻	lwto
潜	iggj
瓶	usaw
偶	ekye
戒	gsjg
浓	iyry
毁	rfqh
销	tmwy
迪	kpdo
拒	agbu
绕	vaqh
勒	gxke
朗	oxvw
嘻	lhll
尾	brmh
帐	mthv
废	uxbo
延	qnxn
敲	ombu
烂	uusi
曼	jmbu
厌	ssqh
宜	omib
羞	ubcg
喂	ljgf
吟	ltov
滴	ioud
洲	iiqc
爹	twrr
艳	dycb
晴	jhwy
抚	afdo
缩	voej
协	dxti
央	kgdf
悔	yqbm
肖	mwya
缠	vukk
脆	wysv
痕	pvnb
伍	efci
寂	okmb
启	ilve
翔	uxxi
薄	sifa
侯	ebqi
劝	bxku
郭	ovcj
奴	cbun
鸣	lyav
倾	erdk
彼	rvpc
扔	avjo
撒	aswe
豫	cyld
检	ftfi
针	tdij
耀	mhxw
痴	pqlv
姆	cbmn
篇	qinc
椅	fgal
厂	shh
董	swkk
熊	vwru
埋	hkkt
乖	wuri
狐	rquq
蒋	sura
踏	nkjr
隆	cefw
括	areo
潮	idjw
唉	lvqi
穷	pxkx
聪	auly
唤	lykg
泰	gkvu
版	tebu
末	hoo
旗	oqdj
仪	eowl
焦	wuoi
猫	rsjt
盗	semn
侍	ehac
挤	apti
款	hhei
拾	ayeo
荒	suqr
姿	secn
域	hglf
搭	asye
脉	wokv
授	aeyb
俗	ettl
融	flkk
狱	rosq
欺	deij
访	ooga
桥	feti
锁	tmkb
霸	dgwy
牵	gywn
池	icys
钻	tmlv
港	istc
喃	ldkd
廷	exnn
乘	ruri
玛	gxmn
奉	gaou
扯	anio
岳	efjs
减	sdfl
弯	pvgi
夹	gueu
辞	roxe
岸	jshg
岂	jbjs
屈	bxxg
恼	ypxg
哲	aelv
季	rvkh
召	blvd
丧	dugf
尝	nsvv
恭	stmo
载	dghc
瘦	prnb
皆	rreb
颇	vdkb
茫	siuw
染	iyfv
肃	xtti
爽	gwww
亏	fski
吞	fglv
惹	ssly
哀	oryl
乔	etio
趁	dtto
铺	tfuj
脏	wuht
吕	llvv
奖	urgd
倍	eilv
汤	ivto
振	asno
婷	coan
牢	ownb
扰	adoo
溜	itjt
庞	udqp
臭	tsqk
悦	yulq
赫	httt
赢	ukbw
跪	nysv
麦	hehf
枝	fdbu
侠	egue
泉	ekvb
劫	hvxk
炎	uuoo
泥	ibri
赌	khjr
弓	vgg
魏	rcwu
罩	mmjd
疾	pqib
饰	rqmv
符	qeac
垂	esjn
映	jkgd
漠	isjg
脖	wdyv
饮	reis
沿	iqlv
懒	yflk
肤	wguy
桑	bbbf
堪	hdxi
燃	uwsu
卓	mjdo
祝	hlqr
赖	flyk
宾	oeft
贾	dkbx
喘	ljsr
焰	uyrj
吵	lmqp
冥	yjot
鞋	ghht
逸	ylqp
均	hwsi
库	uhcu
裤	puhc
碗	dorv
航	qoqj
踢	njwt
姨	cgvg
酸	gvte
啸	lxtt
龄	ntxb
阁	pelv
舌	ree
箱	qfmf
冯	sxmi
邦	dcjn
钢	tkwl
霞	dbsb
促	enve
泡	iwck
盾	edmf
羊	ugg
碧	gedh
援	aehb
忌	byij
抹	ahoo
倩	ehwy
锐	tulq
喷	ldsk
拦	ausi
嘉	hlul
袖	pkoy
殊	frwt
辰	snn
繁	qbeb
络	velv
抛	ayxk
嫁	cods
咒	llqj
撤	aove
键	txax
湿	ijkg
恰	yyei
虫	kcc
审	okeb
献	dkus
媚	cbmf
贤	nbkb
葛	sjwx
刹	wfmd
袁	hlry
摔	aovd
序	ucuu
筑	qfqo
斜	tffd
瓦	aww
涂	itff
湾	ipvg
莎	simq
崇	johs
猎	rsjr
刑	fsmd
墨	nhte
娃	chht
梯	fuvq
桃	fqss
豆	flue
驾	xlxm
浅	ifgg
径	rbfo
饿	rqag
疲	pvpb
搬	aqqh
瓜	quu
莹	sygo
滋	iuvv
润	ipgn
铃	ttob
蛮	pkci
蒂	soum
拨	axbo
涛	idac
予	cuu
勾	wvvy
惠	gyic
析	fejv
砍	deih
撑	antu
截	dgwi
措	asjr
币	qmvp
薇	srfq
愈	tfwy
督	kmbm
酷	gwlv
祥	hugs
怖	ysmv
侵	exyb
岩	jdhs
扮	atbd
糟	psjj
盈	vbmn
腹	wqje
斩	hejc
尺	bodh
签	qtfi
稀	rwsm
掏	awwo
夸	gfsk
汽	iqqs
液	ioeo
姬	cscn
愧	ywui
汇	igfs
柱	fogn
粮	povn
堡	elfh
仗	esod
笨	qffi
奏	gfgd
歉	uxne
甩	wxiy
怔	yfni
允	vqrv
竞	ilqr
祸	hlkt
耶	acjr
爵	emxa
绩	vhkb
诱	orvj
呜	lewv
穴	pxx
黎	rwqk
租	rmih
培	hilv
砸	dgmv
麽	pqvv
井	stii
窝	plkt
弥	vyma
返	ebpd
匹	hxiw
啥	lthl
凑	sgfg
奸	chgn
陌	cdjr
叛	uaeb
核	foiv
卧	smoc
幅	mflj
眨	mqpe
耗	dtrm
洒	idxs
怡	yvlv
详	ouga
卢	mbho
扣	alvo
哇	lhht
丑	bcc
勉	ylqx
孝	hvkt
矛	cqpu
氛	qtbd
衡	rqta
陶	cwwo
购	kwvv
汪	igns
僵	efjf
疗	pvlb
妃	cbjn
罚	momd
棋	fdjv
缝	vedp
咐	leac
躯	wgwl
泛	iqpe
愁	ruyi
搜	arnb
慈	uvvy
肥	wcby
笼	qdqp
篮	qnqm
俱	emti
惟	ywii
柜	fgbu
捉	anvo
悬	mvyi
霍	dwiy
泄	ihis
咽	lngd
齿	ntxg
秒	rmqp
勤	gsxk
扩	auuo
屏	busj
霜	dfmf
袍	pwck
蝶	khfv
祭	whsy
厨	sfla
胁	wxti
璃	gpxv
劈	blob
赚	kuxt
锦	temv
尬	dtti
尴	dnqm
熙	scuo
寺	hact
昌	jjrr
贺	xlkb
巾	mvv
描	asjt
捕	afuo
陵	chte
咳	loiv
扇	ixxi
虹	kfoc
绵	vemv
撕	adej
蔡	swhs
催	ejwi
彭	hlut
宠	odqp
贪	tovk
辱	sacn
誓	aeua
盒	ymne
寸	acc
披	avpo
饶	raqh
搂	apcn
跌	nqgu
欠	eii
肌	wqjy
售	wlvi
巡	vpdc
抑	atxj
纹	vpws
宏	osvv
幼	vxko
萍	sihu
驻	xogn
丛	ttfi
亿	evie
播	aqpj
俄	eqag
刃	bodd
蕾	sdjt
挨	avqi
仲	elns
迈	fwpd
违	avpd
辩	ooox
埃	hvqi
艘	qrnb
琪	gdjn
灾	ouob
僧	eujj
渡	iusb
卑	wdiu
雕	whlw
鼠	rbuj
讯	ovdi
辣	oflv
刷	bmmd
艰	bvnu
斥	eodj
裙	pxql
翠	xxod
饱	rwck
掠	aoma
询	owjr
勃	dyvx
夕	rkk
矮	qrcn
瑶	gewo
赐	kjwt
捏	ajht
闯	pxmn
姚	cqss
瑟	ggyq
渴	ijwx
谅	ooma
昂	jtxj
串	llns
沟	iwvv
涉	inma
咕	ldgv
驶	xlwl
摄	aabb
贫	tbkb
辕	hhlr
婉	corv
鹏	wwya
姜	ucng
碍	djfa
荷	seal
冠	yfha
魅	wheu
玫	gehn
裁	dgor
坡	hvpt
鸿	ifya
邓	bcju
歪	dfni
乏	qpep
申	kee
割	odlm
巫	ftte
衫	ptoy
棒	fgao
阔	pire
泣	iids
韦	avio
恍	ymhw
贯	bdkb
魄	ewub
柄	ffkt
患	llny
覆	drqe
蜜	oyqk
婴	kkcn
励	sfwx
锅	tlkt
陛	crrh
遮	usfp
帕	mebv
咖	lxlv
嫌	cuxt
胳	welv
挖	apvi
啪	laeb
矿	duuh
凄	sdxc
爪	ekk
眠	mcai
穆	remt
啡	lliv
吾	fclv
坛	hsvv
脾	wwdi
恒	yfjf
屠	bhjr
玻	gvpn
蓉	sptl
础	dxxg
曰	jee
耸	ttar
膊	wfac
後	rveh
逆	uxpd
寿	dacn
驱	xgwl
猴	rebq
佣	etne
毅	idqh
舅	rjxk
铜	tkfl
娟	clwy
眯	mpmf
淫	ieen
吩	ltbd
匪	glif
牧	wehn
役	rqhc
寄	ogal
诡	oysv
纤	vwks
腐	ueat
姻	cngd
晰	jfej
渊	itpm
亭	oanl
邀	eoep
哄	lsti
骚	xbok
墓	sjgh
柯	falv
筋	qwxk
崔	jwis
灿	ujso
捷	afxn
淋	iffv
弗	vtig
辑	hlar
棍	fjrr
绳	vlkd
频	nmdk
廊	uoxc
畏	jgft
歇	jwte
裹	ojfr
苗	sjtj
盼	mtbd
咯	lelv
耍	scnr
煞	yxeu
寝	ouxb
瞒	msft
添	ifgo
嫂	crnb
纠	vxgs
慨	yxvq
嚷	lolr
驰	xcym
拐	alxk
宴	ojcn
津	ixao
岚	jqwl
浴	ittl
耻	anir
挽	aylq
页	dkbh
誉	itua
牲	wwgn
乳	evxi
仓	tvie
逝	aepd
喉	lebq
逛	rgpd
樱	fkkc
兼	uxnt
戈	ggg
哗	lerd
涯	ishh
捧	agao
铭	trlv
障	cijd
摊	abwi
跨	ngfs
妥	ecnk
揉	acqf
晋	aujr
寞	osjg
寨	ostf
漆	iftk
污	ifsk
嘲	ldjw
枚	fehv
吊	lmvv
乾	djqv
馨	hbqj
伪	eoxo
嗓	lbbf
呈	lgnv
卿	txvv
楠	fdkd
籍	qdtj
裸	pjfv
链	thpd
灌	islw
昆	jrri
畅	kvto
逍	mwpd
帽	mksm
阅	pulq
逗	flup
蹲	nuga
踩	nefv
窜	plln
哑	laue
趴	ntiv
逢	edpd
植	fdmi
媒	cssf
韵	ijws
昭	jblv
尹	xqpl
谦	ouxt
档	fmxl
趟	dnsk
沾	imlv
兔	ylqo
订	oana
朴	fmov
瞎	modl
鞭	gefw
俺	egkd
斤	ejj
翅	dbxx
肠	wvto
雀	mwia
慎	ydmt
盆	tbmn
迁	wpdk
镖	tdhs
芬	stbd
崖	jshh
丘	efij
蠢	gjkk
庙	ukou
潘	iqpj
颖	rrdk
拓	adho
娶	abcn
纱	vmqp
漏	ibdy
谨	ogsi
珊	gwwf
仆	emoe
宙	okob
尉	bhac
屑	bmwy
叮	lanv
捂	afcl
涩	ibon
诧	ooqa
柴	nrfv
杆	fhgv
涵	ivkx
坠	ctht
赔	kilv
涨	ivth
嘟	lhjc
崩	jwwy
薛	syox
藤	swuk
税	rulq
枯	fdgv
译	obao
帘	pmvx
糖	puxl
愉	ytfm
骄	xeti
羡	usei
糕	puuo
彬	ffto
愚	kyiy
疏	vnoq
翰	djtx
堵	hhjr
腕	worv
眸	mvwn
芸	ssvv
溪	ievg
殷	exvq
谎	osuq
鼎	mxtp
稿	rolh
哟	lvwo
冤	yylo
症	pfni
棵	fjfv
狄	ruoq
咧	lfrm
湘	ifmf
宛	orvi
嫩	cfle
肆	hxao
宰	ooxb
憾	ydfy
偿	ensv
腔	wpfo
哩	lkkv
豹	ywod
瑰	gwun
鉴	nqwj
绑	vdcj
潇	isxt
戚	dkma
郡	xqlc
澡	illf
桂	fhht
兮	tski
雯	dpwy
颠	dmtk
狮	rufm
邻	tobc
契	dbgd
骇	xoim
卜	moo
揭	ajwx
妄	ucnw
坑	hoqj
伐	egge
矩	qgbu
烁	utma
葬	sfrs
诀	obte
鄙	ldnc
鹿	ill
柏	febv
溃	ilkk
朕	wugd
舟	qoo
妆	ucne
躁	nllf
霉	dqbm
侦	emkb
冻	sama
娅	caue
庸	uxwy
筹	qdac
削	mwmd
砰	dhue
耿	auor
牺	wdxn
筒	qkfl
遂	udpd
旭	yjrf
胎	wvlv
惶	yegn
淑	ikmb
叉	bodu
痒	pugb
竖	nbid
龟	ykdm
斑	gpgn
儒	edsr
嫣	cfnu
宅	oqai
押	akjo
胃	jwyt
旨	rjri
册	wwfi
膝	wftk
浸	ixyb
弦	vovo
栏	fusi
衷	onry
刮	rmde
艇	qexn
岗	jkwl
赴	dmok
囊	dlyr
斧	twej
颊	gudk
疆	vhff
炉	uieo
塌	hjxx
旺	jgnr
乞	qvik
烤	uhsk
黛	egne
逊	vmpd
贱	kfgg
辨	ouox
狸	rkkq
叙	tffb
愕	ylls
叠	bbbm
遣	lkbp
晌	jrnr
麟	ipra
腥	wjwg
粒	pidm
拟	axot
俏	emwy
杖	fsod
芝	spej
夷	gvgd
衬	pacy
佐	esfo
巷	stck
捡	atfi
遵	ugap
塑	uxwh
桶	fbtn
泼	ixbo
滩	ibwi
琼	goma
昊	jfgd
帆	mqod
搏	afac
颈	bfdk
噢	lrpg
蹦	njww
寡	odmb
贞	mkbo
凰	qegn
哨	lmwy
拆	aeod
茹	sclv
劣	mqxk
嘱	lbqk
沃	ieos
厢	sfmf
摘	aoud
咋	lqmo
坤	hket
俯	euea
媳	ctyi
赋	kfgn
嘶	ldej
贡	fkbo
碌	dxkv
匙	jfnr
拢	adqp
谭	odjd
翁	tvxx
辜	doxg
竭	ijwx
廉	uuxt
械	fgsj
贸	tkbm
辅	hfuc
讽	oqwl
呐	lkte
斌	pfgn
辽	vpdl
填	hdmt
窃	pabd
溢	iutm
抄	amqp
妒	cien
吁	lfau
嗦	ldyb
掀	aeei
芙	sguj
祈	hejs
栋	fama
吱	ldbu
撇	aume
胞	wwck
轿	heti
禅	hujd
妨	cogn
拂	avti
倦	eugv
衰	ofry
靖	ihwy
循	redm
挪	avac
蓬	sedp
惩	rfny
垃	hidt
账	kthb
驳	xwwl
署	mhjr
甫	fuu
顽	fhdk
姥	chri
圾	hvod
熬	hweu
枕	fyqr
丐	afxi
茜	sdxj
咦	lgvg
厕	skmd
攀	fwwt
彤	woto
妍	cfsj
拽	akqp
荆	sfsm
妓	cdbu
壶	hykg
於	otsi
寇	ofhb
鹤	ywya
钥	twyj
骤	xabs
渺	immq
刊	hmdg
肢	wdbu
烛	ukco
孕	vvkj
绽	vofn
彦	iqto
棉	femv
俘	eevk
盔	sumn
剪	uwmb
诞	oqnx
兜	etbq
凛	sonh
岭	jtob
嚣	lldl
溅	ikfg
笛	qkok
舱	qtvi
罕	ythg
鸭	kyaj
债	ehkb
噬	lqft
钉	tanj
躬	wvgm
倚	egal
缕	vpcn
咚	lesi
撼	adfy
蕊	syyy
侄	ehke
佑	eslv
雁	sewi
隶	xkvl
践	nfgg
拱	asti
沐	ifvs
菊	swpm
蜂	kedn
裕	pttl
兆	qssi
搅	aiyk
尿	bkvh
黯	nijr
歹	frki
蓄	sovj
朦	wsyd
嘀	loud
怯	yhvv
叨	lbdv
纽	vbcs
聘	aksk
腻	wgsk
剥	xkmd
彪	mtou
沸	ivti
氓	ucai
榜	fouo
逻	mrpd
壳	hyqj
储	eohj
憋	umty
啤	lwdi
匠	gejf
悍	yjhg
昧	jher
泊	iebs
篷	qedp
烫	ivtu
狡	rotw
轨	hyfc
汹	iwxg
携	awvj
磊	dddh
隙	cmjm
仑	trie
摧	ajwi
瞄	msjt
胧	wdqp
趋	dyxl
挠	aaqh
煌	uegn
擅	aonf
卒	ottd
饼	rusj
狭	rgue
丸	yodf
惫	ejyi
瞅	mruo
犬	sqq
砖	dsxo
矣	vqiv
楞	fmog
昔	sjrj
裳	nory
骆	xelv
雇	iwie
阎	pyrj
骷	mdgg
鸦	hyay
妞	cbcn
墅	kcht
焚	ffuo
谱	oukj
绘	vtsv
梳	fovq
肿	wlns
魁	wsdi
耽	ayqr
擒	atpv
陡	cdkj
璋	gijd
茂	sdwj
蹄	noum
瞥	umtm
瞳	mikk
髅	mpcn
绣	vrvj
硕	ddkb
肺	wfmv
兹	uvvo
炒	umqp
邮	kcjo
弘	vvvg
嫉	cpqi
届	bkoh
嗡	ltvx
娱	clfg
喧	loff
脂	wrjr
膛	wnht
沧	itvi
疚	pyod
盐	hmmn
扁	ince
搁	apel
茅	scqp
滔	ierj
坟	hpwt
掐	ayrj
瑜	gtfm
邱	efcj
桐	fkfl
茵	sngd
苹	shue
旷	juur
翘	aqhx
郝	httc
蓦	sjgx
诈	oqmo
沫	ihos
菁	shwy
粹	potd
琢	gdod
腊	wsjr
钦	teij
喻	ltfm
宪	owqr
锻	tefq
睹	mhjr
郊	otwc
饥	rqjs
侃	elqr
粘	pmlv
媛	cehb
谊	oomi
恳	vyin
厮	sdej
锤	tesj
凳	bflq
淮	iwis
蔽	sume
聂	abbu
贩	kebu
潭	idjd
翩	inxx
呻	lkev
枉	fgnv
拘	awlv
煮	hjuo
焉	fnsu
址	hnit
匕	rii
渗	ivgt
览	nqkx
敦	oveh
厦	sdme
蕴	svjm
冉	khtf
薪	sife
呃	lsvi
峻	jvte
荐	ssnv
栽	dgfv
嚎	lods
汁	idis
傍	eouo
秃	rqjh
磕	dhvm
禀	onlh
珑	gdqp
坎	heit
邵	blcj
萌	sjwy
窄	pqmo
阮	cfhw
蹈	nerj
碑	dwdi
婶	coke
煤	ussf
寓	okyb
栈	ffgg
滞	isym
倘	ense
杭	foqj
暇	jbsb
狈	rkbq
峡	jgue
侣	ellv
芦	siej
蔓	sjmb
蒸	svku
禄	hxkv
胀	wthy
醋	gsjr
淌	inss
伞	tudi
姊	cqxq
钩	twvv
衍	riah
妾	icnd
嘎	ldmg
蜀	mwkc
蝴	kdwy
萝	smrk
莽	sssj
弩	cbvg
祷	hdac
稚	rwih
圳	hqct
徽	rfbs
衙	rfca
咸	dflv
陋	cfkx
奢	ghjr
罐	wslw
霄	dmwy
毙	rrfr
汝	icns
敞	nehs
暮	sjgj
嘘	lmkg
灼	uwod
澜	ipfu
姗	cwwf
倪	erqr
挫	atth
咪	lpmv
钧	twsi
捣	ayjs
燥	ullf
泳	iokv
眶	mggn
乙	vii
澈	iove
焕	uykg
酬	giqc
筷	qybt
宵	omwy
缚	vfac
揪	aruo
蚁	kowl
喇	lflm
丞	vkfi
拎	atob
棠	nfvs
咙	ldqp
梭	fvte
哧	lhtt
棺	fobb
璇	goqn
瀚	idjx
肝	whgy
敛	tfie
剂	ptmd
疤	pcbb
渔	iqys
嗔	ldmt
沮	imis
廖	uxxt
虏	mxku
皓	ewlv
勋	lkxk
恕	clyi
虐	mxlu
虞	mlfg
综	vohs
瘾	pcyy
驴	xiem
晒	jdxr
卦	hhmo
迦	xlpd
陀	cori
窥	pgkx
堕	cswh
哆	lrrk
葡	swfu
帖	mmlv
垫	ayoh
屡	bpcn
鹅	qagy
蛛	kwti
盲	umfw
碟	dhfv
狞	roan
囚	ntew
诊	otto
揽	anqk
裴	lory
捞	asyx
吏	flwl
铮	tyxv
萄	swwo
盏	fgmn
霆	dexn
喔	lbhk
贷	egkb
勿	wtoy
吭	loqj
淘	iwwo
辟	blox
蔑	smdo
淹	igkd
麒	idjl
喽	lpcn
栗	dfvx
绷	vwwy
惚	ywty
桓	ffjf
桩	fuht
坊	hogt
嗽	lfle
履	brqe
璐	gnel
菩	silv
巢	vjfv
畜	ovjt
兀	hww
樊	fwwg
锡	tjwt
棚	fwwy
仕	ehfe
倏	enes
芹	sejj
僻	eblo
絮	clbs
杏	flvv
浆	urkv
瘫	pbwi
啧	lhkb
磁	duvv
冈	kwlf
逮	xkpd
搓	aufo
赠	kujj
胶	wotw
脊	sstw
噩	glll
绰	vmjd
呕	lgwl
嚼	lema
谐	orre
歼	frwk
揣	ajsr
殖	frdm
拧	aoan
伺	evfl
霖	dffv
驼	xori
襄	olsr
衔	rtah
惕	yjwt
掷	augc
卸	qfnx
炽	ulti
敖	hweh
惭	yhej
框	fggn
捆	anfv
眩	movo
蝉	kujd
谜	oppd
炫	uovo
塘	huxl
阱	csti
膜	wsjg
亨	ovll
奕	pgdi
蚂	kxmc
猩	rjwg
滨	ioet
沁	iyis
跋	nsbo
藩	siqj
舔	rfgo
捐	alwy
歧	ndbu
隋	csfw
蹭	nujj
甄	dhaw
蜡	ksjr
嗤	lxfk
缸	wfoo
嬉	chll
哮	lhvk
熄	utyi
窍	pfsk
俞	tfwm
豁	odll
垒	vvvh
掘	abxx
琦	ggal
屎	bpmh
乍	qmok
孽	syov
毯	ruuo
弧	vqug
槐	fwuv
铠	tjbj
挟	ague
襟	pffh
梨	rmfv
嗅	ltsq
祁	hcjs
纲	vkwl
渠	igbf
矢	qii
捅	abtn
扛	afoo
朽	fskv
忖	yaci
匈	wwxg
扒	atio
雍	ovqw
莺	syya
侮	eqbm
闺	phht
霓	drqr
稽	rdrj
斋	psrw
夭	eoo
沦	itri
揍	agfg
瞟	mdhs
苟	swlv
琉	govq
漪	irgl
暑	jhjr
窟	pbxx
钓	twod
鳞	qpra
瓷	seaw
萱	soff
株	fwti
倭	ercn
鞘	gmwy
沛	ifmv
噜	lqjr
绞	votw
颓	rqdk
睿	myfm
噗	lkug
唔	lfcl
幢	mikk
喀	loel
诅	omia
涕	iuvq
拣	aavt
谣	oewo
叽	lqjv
葱	swty
拭	agfo
婢	cwdi
铸	tdac
绮	vgal
剿	vjfm
胤	qvwy
秩	rqgu
畔	juao
粥	vpvg
奎	ghht
绸	vwhl
茨	ssei
熏	wnek
蹬	nbfu
诏	oblv
岔	tbjs
叭	ltiv
咆	lwck
滥	inqm
梧	ffcl
垮	hgfs
澳	irpg
浙	iaej
甸	wjty
绯	vlis
诛	owti
鲍	qwck
刁	vfii
厥	suxe
蚊	kpwc
鞠	gwpm
歆	ijei
拙	axxg
茗	srlv
眷	ugmf
戮	xxtg
唬	lmuv
骏	xvte
扳	aebu
踹	njsr
漓	ipxv
蝇	klkd
擂	adjt
涡	ilkt
沌	iaxg
凸	nfnf
酿	govn
蚩	xfkc
唾	lesj
琐	gmkb
犀	bkwn
澄	ibfu
哉	dglv
猾	rmgq
煎	uwmu
窒	phkx
虾	kakc
蝠	kflj
钞	tmqp
瓣	oqox
唧	lxvx
觑	mkkx
哽	lfjw
娥	cqag
婿	cvnw
讪	ojsa
耕	dtst
葫	sdwy
暧	jeyb
浇	iaqh
嗨	liqb
诵	obtn
疫	pqhb
兢	dqdq
箫	qxtt
颅	mbdk
啼	loum
绅	vkes
杉	ftov
嗜	lhrj
券	ugbd
遁	edmp
炯	uklv
霎	dicn
讥	oqja
迭	qgpd
彷	rogc
觅	ekxk
娴	cpfv
抿	acai
剔	jwtm
稻	rerj
敷	foeh
泻	iysf
怠	vlyi
龚	dqst
绒	vgso
讳	oavi
勺	wody
函	vkxg
喳	lfjf
颂	tvdk
搀	ayls
撩	agum
擎	swlt
巍	jrcw
脯	wfuy
镶	tolr
寥	oxxt
漾	iuok
缴	veoe
藉	sdtj
弊	umts
逞	lgpd
膏	owyl
戳	xxwg
呛	ltvi
凹	kfif
叩	lxjv
禽	tpxv
懊	yrpg
懈	yytw
蛟	kotw
亢	oqjb
呸	ldfi
芊	swkj
慑	yabb
跺	nqfv
跄	ntvi
蚀	rkcs
栖	fdxv
蔚	sbha
铲	tiqp
坪	hhue
筝	qyxv
顷	rdkb
腮	wjyi
踉	novn
狰	ryxv
踱	nusb
嗖	lrnb
苑	srvi
秉	rxlh
猿	rhlr
堤	hjfn
佟	eesi
悯	yppw
唠	lsyx
憨	vaey
肘	wacy
拇	abmo
僚	egum
霹	dblo
婕	cfxn
禹	qkkf
啃	lnwy
匀	wsiy
晖	jyhc
怅	ythi
聋	dqar
拯	avkf
忿	tbyi
韧	avbo
邹	yxcj
梢	fmwy
肋	wxky
窘	pxql
嵌	jsse
婪	ffcn
辖	hodl
浦	ifus
炭	jsuo
曦	jurg
簇	qoqq
螺	kjbs
酱	urgo
屯	axgi
悴	yotd
匡	ggnf
冀	urjt
倔	ebxx
橙	fbfu
陕	cgue
筱	qene
叱	lriv
髓	msfp
淳	iovk
矜	cqtv
詹	ystu
菱	shte
芷	snij
惺	yjwg
浊	ikcs
囔	ldlr
朔	uxwy
憔	ywuo
睫	mfxn
睬	mefv
鸽	yyae
臀	bstw
吨	laxg
笙	qwgk
戟	djgg
沼	iblv
谍	ohfv
昕	jejr
蛊	kmnc
煜	ujid
祀	hcks
罡	mfni
伶	etob
荫	scwy
酥	grho
懦	ydsr
厄	svih
峨	jqag
轴	hkoc
伽	exlv
雳	dsxk
卵	tood
捶	aesj
檐	fysu
棘	fkfk
嗣	lnvl
钗	tbod
袜	phoy
妩	cfdo
炕	uoqj
偎	ejgf
窦	pdvg
蝎	kjwx
溶	iptl
幺	voo
膨	whlt
峙	jhac
缉	vlar
徊	rnlv
呗	lkbv
衅	qmua
砂	dmqp
舵	qori
昼	bojf
迸	uspd
斟	dxsd
舆	rhft
椒	fkmb
靓	hwkx
旬	wjry
厘	skkh
窑	pwox
萎	srcn
涟	ihpd
疙	pqvi
芠	spwj
瘩	psye
梵	ffqo
靴	geri
侥	eaqh
匿	gssl
挚	ayot
镯	tmwk
兑	ulqr
尧	aqhw
徘	rlic
芽	shyj
狙	rmiq
闵	ppwn
辫	ovox
瀑	ijsk
嗷	lhwe
庐	uieu
芯	syij
禾	rhh
澎	ihlt
邢	fscj
绊	vuao
蜘	kqlv
憎	yujj
靡	plia
褚	phjr
湛	idxi
蒲	sifu
嚓	lowh
珂	galv
崽	jjyi
贬	kqpe
惮	yujd
婵	cujd
嗒	lsye
悸	yrvk
晦	jqbm
涅	ijht
恬	yrei
慷	yuxk
穹	pvgx
渣	ifjf
屉	bhih
缭	vgum
绢	vlwy
嬴	ucnw
袱	pesq
黝	nvxk
袅	yory
淇	idjs
茄	sxlv
寅	ofkt
赦	htte
悻	yhud
祟	xxhs
榻	fjxx
蛙	khht
苇	savi
嵩	jols
茉	shoj
唰	lbmm
咏	lokv
凿	kudx
粪	psti
噪	lllf
菌	snrh
蝙	kinc
庶	usfu
邸	taoc
晟	jdvi
禧	hhll
攒	awqk
虔	mpwu
旱	jhgr
琛	gytf
榴	ftjt
漱	ifle
忑	ayik
匣	gkjf
忐	kyis
谬	oxxt
蟒	ksss
棱	fhte
钝	taxg
悚	yflv
廓	uovc
惘	ykuu
漉	iils
蟹	ytbk
佬	ehri
曳	kqpd
赎	kdvg
壤	holr
忡	ylns
倡	ejjr
冶	svlv
姝	cwti
筠	qhws
竿	qhgk
蜷	kugv
癌	pllj
嘈	lsjj
蚕	fgkc
剖	ilmd
颁	tbdk
缀	vbbb
汀	ians
谕	otfm
牡	whtn
斐	lpwi
懵	ysmm
皙	feeb
缪	vxxt
蔷	sdul
诫	ogsj
恤	yqmn
咄	lxxg
馒	rjmb
矫	qeti
痞	pdlv
橘	fcql
氧	qugq
贿	kswy
肮	woqj
瑾	ggsi
璧	bloo
烙	uelv
攘	aolr
攥	aqmb
汰	igod
溺	ivss
铅	tqlv
咔	lkmo
芭	scbj
戎	gsog
褐	pjwx
巩	fqod
吆	lvov
彰	ijto
漩	ioqn
聆	atob
蒜	shhs
棕	fohs
鹃	lwya
帜	mlti
鄂	llfc
搐	aovj
蔼	sojx
怦	yhue
穗	rgyi
亩	ojtb
撰	acct
绎	vbao
牟	vwnv
咨	selv
奄	gkdd
梓	foxv
绚	vwjr
阀	pegg
烘	usti
炙	wuoy
翎	tobx
惋	yorv
驯	xqcm
栩	fxxi
逾	tfwp
墟	hmkg
鬟	hmfr
茬	ssnh
褪	pvpd
鑫	wwwj
骸	moig
峭	jmwy
缅	vgis
灶	uhto
洽	iyes
祯	hmkb
暄	joff
裔	orkl
韶	ijbl
缎	vefq
砚	dkxh
锥	twij
辙	hove
惦	yuml
铛	tmxl
枣	fksi
桦	ferd
邃	pudp
橱	fsfa
搔	abok
腑	wuea
萤	sykc
枢	fgwl
遏	jwtp
募	sjgx
憬	yjom
庵	ugkd
叼	lvfi
嫖	cdhs
苛	salv
锣	tmrk
蹑	nabb
拌	auao
奠	uggd
秽	rjrk
殴	gwqh
喋	lhfv
糙	pwlp
貂	yblv
揖	alar
葵	sbfg
榆	ftfm
颐	sdkb
皂	eaib
眈	myqr
扼	asvi
眺	mqss
孜	vehk
簌	qfle
玺	ymgo
偌	essl
蹿	npln
蓓	seil
弛	vcyg
庇	urri
檀	fonf
枭	yfva
螂	koxc
趾	nniv
崭	jhej
妲	cjfi
掂	auml
醇	govk
掺	avgt
驿	xbao
槽	fsjj
惬	yggu
镰	tuut
抡	atri
憧	yikk
删	wwfm
鸳	rvya
酣	gssi
宦	oscb
筐	qggn
琅	govn
瞻	mysu
焱	uuuo
飙	sssw
湃	itfd
俨	eauq
跷	naqh
栅	fwwf
撅	asue
煽	uixx
呱	lquv
缰	vfjf
猝	rotd
衮	otvr
肴	wswy
殆	frvl
谴	olkp
蔬	svnq
飒	iqwl
婧	chwy
阐	pujd
荧	syuo
侈	errk
霏	dliy
瘟	pjmn
芜	sfdo
俭	etfi
崎	jgal
亥	oii
俐	ermd
屿	jsfi
譬	blou
饺	rotw
垄	dqht
畴	jdac
杠	ffov
鬓	hoet
讼	otvv
晏	jocn
弈	psji
鞍	gocn
瘸	pxlt
钮	tbcj
珏	ggod
钰	tgod
傀	ewue
噔	lbfu
驭	xbum
靶	gcbe
萦	sybs
韬	aver
恙	uyig
懿	hyfy
竺	qsik
吝	plvw
羁	mgxm
荀	swjr
癫	pdmk
嘭	lhlt
菇	scdg
恃	yhac
儡	ejjj
瘪	pttr
踌	ndac
呦	lvxk
榕	fptl
昵	jbri
躇	nshj
烬	ubos
啰	lmrk
酌	gwod
丙	fkte
涎	iqnx
哒	lgpd
冽	sfrm
鸾	pyai
砌	dabd
烨	uerd
翟	xxwi
辗	hbsg
噎	lhyu
驹	xwlv
噼	lblo
咎	emlv
亵	oayr
陨	clkb
蠕	kdsr
冕	ksyq
雌	nrwi
茸	sarj
瑛	gskg
剃	uvnm
掰	ttbt
蹙	dkmn
橡	fyld
佯	euge
笃	qxmk
崛	jbxx
勘	dxxk
稼	rods
桀	rafv
渝	itfm
拚	avsj
汐	irks
锈	trvj
磅	douo
壕	hods
娄	pcnm
撮	ajab
玑	gqjn
祠	hvfl
鹫	omdy
娲	clkt
黏	rtkl
珀	gebn
睽	mbfg
栓	ftgn
绫	vhte
阑	pfnu
邑	lcbv
瑕	gbsb
磋	dufo
粟	dpmx
薯	smhj
沪	iies
讷	okte
岑	jtov
炜	uavi
玮	gavi
娼	cjjr
迂	fapd
伎	edbu
鲸	qoma
翡	lxxi
坝	hkbt
铐	thsk
洼	ihht
蹊	nevg
寐	oxhe
肾	nbwy
鸯	kgya
這	upda
敝	umte
涧	ipjr
崆	jpfo
甭	dtnu
笠	qidk
扈	ilcb
哝	lyry
芮	skte
卉	dsji
靳	geje
诬	oftt
札	fxiv
婊	chry
裘	fkor
扉	ilie
疮	ptvi
巅	jdmk
坞	hewt
膳	wuul
剌	flmd
鳄	qlls
捺	aghs
悼	ymjd
茧	skcj
毋	bsom
馅	ryrj
曙	jmhj
簸	qdvp
忒	gyiy
妳	cyma
叟	rnbu
拴	atgn
嬷	cpqv
稣	qrhy
痹	pjaj
垣	hfjf
蛤	kyec
谏	ofnu
羹	uuug
沥	isxk
蛾	kqag
瑚	gdwy
個	endg
熔	uptl
雏	yxwi
惆	ywhl
饷	rrns
拗	avxk
燎	ugum
熠	uxxe
薰	swne
蕃	sqpj
捋	aeac
籁	qflk
髦	hrma
飓	qwmt
簿	qifa
迢	blpd
汩	ijes
闸	pkjn
狩	roac
鲨	imqq
蜥	kfej
惴	yjsr
胯	wgfs
侨	eeti
劭	blxk
烹	ovuo
咣	lmhw
攸	eneh
锄	tmxk
硝	dmwy
颔	tovk
鸥	gwya
滕	wugk
寰	omfr
紊	pbsw
蕉	swuo
稠	rwhl
蟆	ksjg
垢	hefl
楷	frre
炊	ueio
忻	yeji
炳	ufkt
腆	wkst
褒	oelr
酋	ugoe
赃	kuht
拈	amlv
抒	acuo
孰	ovyo
袄	peoy
褂	phhm
孺	vdsr
胭	wngd
赘	hwek
礁	dwuo
嫡	coud
珉	gcai
啜	lbbb
钳	tssi
晾	joma
茎	sbfo
隧	cudp
窿	pcew
骋	xksk
嫦	cnmv
槛	fnqm
掳	amxk
莞	sofh
瓢	dhqu
曜	jxxw
锯	tbdg
猖	rjjr
遐	bsbp
蹋	njxx
飕	qwrb
渍	ihkb
麾	prma
猥	rjgf
篝	qskh
殉	frwj
枷	fxlv
蜒	kqnx
皎	eotw
霁	dpti
诩	oxxi
窖	pwlv
咫	bolt
檬	fsyd
乒	efqp
奚	evgd
淤	iots
溯	iuxw
凋	swhl
纺	vogs
篱	qpxv
泌	iyqp
刨	wcmd
樵	fwuo
忏	ywki
盎	kgmn
戾	isqe
咀	lmiv
屹	jqvi
挎	agfs
羔	uuog
殃	frkg
庚	uxte
淼	kkkv
淀	iofn
隘	cutm
绛	veao
缨	vkkc
焘	dauo
璨	gmrp
跤	notw
锵	tura
摁	angy
痊	ptgn
嫔	coet
來	dll
臻	hgrh
泯	icai
糜	ppma
睦	mhth
缥	vdhs
喵	lsjt
褥	psac
魇	sswu
汶	ipws
馋	ryls
渎	idvg
蜿	korv
抠	agwl
诶	ovqi
墩	hove
棣	fxkv
沓	kjrv
喏	lssl
诲	oqbm
琶	ggcb
缈	vmmq
缔	voum
酝	gsvv
耷	gard
弼	vdjv
柬	fnue
浏	ipmd
拷	ahsk
剁	qfmd
柿	fomv
琵	ggrr
沂	iejs
蕙	sgyi
捻	atoy
帛	emvb
柠	foan
饵	rars
撂	ajel
娓	cbrm
乓	efod
轲	halv
髯	hkht
娉	cksk
圭	hhtt
璀	gjwi
苔	svlv
肪	wogy
吮	lvqr
瞩	mbqk
啄	ldod
帷	mwiv
箍	qagm
蟑	kijd
炖	uaxg
梗	ffjw
捎	amwy
瞿	mmwi
嗬	lsel
蘑	spdh
唏	lwsm
鹊	sjya
矶	dqjh
羌	uxig
骼	melv
筛	qufm
鲤	qkky
羲	ursg
祺	hdjs
馈	rlkk
伫	eofi
羿	xxsj
苞	swck
犁	rmwn
铎	tbao
啬	dunl
舷	qovo
矗	dmdm
癖	pblo
掣	wkmt
匾	ginc
谧	oyqm
瀛	iucn
珞	gelv
衲	pkte
毓	qboq
恺	yjbj
纬	vavi
惰	ysfw
嘤	lkkc
诣	orjr
谛	ooum
藻	silf
啷	loxc
佘	thse
黠	nhlv
饲	rvfl
虬	kxic
涤	iefv
骡	xjbs
钵	tffi
邯	sscj
笋	qxqp
瑀	gqkk
芥	stti
醺	gwne
舜	eyra
佼	eotw
龌	ntxh
簪	qgqj
痰	puuo
蹂	ncqf
恻	ykmd
簧	qskt
甥	wjxk
腼	wgiy
驮	xgdm
缤	voet
潺	ibvv
獠	rgum
筏	qegg
锭	tofn
阙	puxe
粤	rpsk
瞌	mhvm
琏	ghpd
髻	hhlv
龊	ntxn
椎	fwiv
唆	lvte
煦	jwlu
嵋	jbmf
幡	mqpj
翌	xxid
毡	rmlv
碳	djsu
鸨	rdya
闽	pkcn
躏	nspw
蜓	kexn
咻	lefv
捍	ajhg
睨	mrqr
鼾	tjah
桔	fhlv
娆	caqh
抉	abte
蜻	khwy
玟	gpwn
徨	regn
嗲	ltwr
碾	dbsg
哐	lggn
粼	prav
啐	lotd
谑	omxl
嚏	ldyn
甬	btnu
鳖	umtq
榨	fpqm
倜	ewhl
稷	rjte
妤	ccun
篡	qmgv
晤	jfcl
肇	iexa
咂	lgmv
帚	xymv
瘤	ptjt
瞠	mnht
嚅	ldsr
怆	ytvi
镔	toet
撵	aggh
裆	pmxl
腺	wekv
骁	xaqh
箐	qhwy
坷	halv
螃	kouo
冢	ydod
锢	tndg
晁	jqss
濒	inmk
蝗	kegn
烽	uedn
辘	hilc
莘	soxj
撬	arrr
澹	iysu
瓮	tvaw
亘	fjfi
钊	tmdj
篓	qpcn
缇	vjfn
泓	ivvv
宸	osnb
鞑	ggpd
胄	kwyo
羚	utob
绥	vecn
笺	qfgg
荤	syhc
迄	qvpd
踞	nbdg
桨	urfv
慵	yuxw
噤	lffh
幌	mjmh
荻	sruo
跚	nwwf
袒	pjfi
浣	iofh
榄	fnqk
痪	pykg
荼	stff
晗	jtol
阉	pgkd
腋	woeo
骰	mqhg
曝	jjsk
涮	ibmm
踵	nwkk
炬	ugbu
涣	iykg
俟	evqi
皑	ejbj
瞑	myjt
渲	ioff
擞	apce
赂	kelv
湮	idht
麓	ffil
铿	tnbh
埔	hfut
峦	pjsi
噘	lsue
涓	ilwy
掬	awpm
怏	ykgd
莓	sqbm
萃	sotd
呲	lnri
蹒	nsft
鳌	hweq
睐	mfpm
昱	jidr
旌	oqwg
摞	ajbs
們	ekne
吠	lsqv
濮	iekg
卞	omob
琬	gorv
谙	oijr
啕	lwwo
轶	hqgu
搪	auxl
陇	cdqp
纨	vyod
膺	ueww
皋	egdi
霭	dojx
呓	lsvi
橄	fvae
纶	vtri
垛	hqfv
嗫	labb
盅	lnmn
拄	aogn
踝	njfv
臧	gxsc
淅	ifej
岌	jvod
岱	egjs
璞	gkug
缄	vdfl
秧	rkgd
翱	egdx
卤	mnwl
逅	eflp
靥	ssgi
磐	qqdh
壑	myfh
斓	ppfu
翊	ixxi
挛	ptui
琰	guuo
叁	vgfa
佗	eori
阖	phvm
怂	ttyi
戬	aujg
汲	ivod
垠	hvnt
迥	klpd
邂	ytbp
咛	loan
杞	fbjv
痘	pflu
臊	wllf
藕	sdtk
湄	ibmf
媲	crwr
癞	pflk
辄	haxi
獒	hwes
恪	yelv
砾	dtma
痉	pbfo
吒	lqai
蜕	kulq
椰	facj
仨	efae
纣	vacs
馁	recn
镐	tolj
蜈	klfg
窈	pvxk
說	utlq
秤	rhue
桢	fmkb
粱	ibtp
辐	hflj
悖	ydyv
涔	ijtv
偕	erre
渭	ijwy
汴	iomo
蜴	kjwt
桅	fysv
隅	ckyj
卯	tmm
骜	hwex
孚	evkk
禺	kyy
琥	gmun
阚	pvae
杵	fqdi
掖	aoeo
畸	jgal
晔	jerd
婀	ccal
菡	svkx
噶	lsjx
昙	jsvv
坍	hwob
俑	ebtn
滤	imyi
侏	ewti
潦	igum
挲	imqt
覃	djdx
硫	dovq
俸	egao
蟠	kqpj
弋	gyy
梆	fdcj
驸	xeac
馀	rtff
笈	qvod
忱	yyqr
恿	btyi
胥	vnwy
垦	vhtn
滢	isyo
窕	pqss
滇	idmt
珅	gken
邬	ecjw
圃	nfuw
咿	lexq
瘴	pijd
徙	rnnf
舫	qogo
嗝	lfln
泞	ioan
藐	syeq
赣	ijek
鹦	kkcy
逵	hthp
戍	dodw
榭	fwac
牠	wcyn
揩	arre
熹	hluu
蟾	kysu
霾	dykk
蔫	sfnu
跛	nvpv
岐	jdbu
脐	wpti
糗	ptsq
螳	knht
哺	lfuv
鹭	nely
蚣	ktvv
炀	uvto
嵬	jwus
褶	pxxe
恸	ysvx
隽	wvji
飚	qwuu
玥	gwyn
籽	pvkm
釜	twhu
剐	lktm
鸠	yyaf
磷	dpra
沒	iwbu
娑	imqc
谄	oyrj
巳	ckk
恣	seyi
猬	rjwy
酪	gelv
溟	iyjt
丕	dfiu
隼	wdii
峒	jkfl
芋	sfau
觊	jbkx
旖	oqgl
筵	qqnx
娣	cuvq
婠	cobb
盹	maxg
涸	indg
颌	ydkb
劾	oxki
趔	dfrm
殇	frqt
噌	lujj
轧	hxic
沽	idgs
愫	yhbs
鸢	gyay
龇	ntxr
玷	gmlv
掸	aujd
趄	dmik
溥	ifac
疵	pnri
皖	eofh
邺	kcjg
杳	fjrv
聿	xaol
镀	tusb
祎	havi
鹉	fgny
匍	wfuy
崴	jdfc
岖	jgwl
幔	mjmb
蝈	kngo
雒	elwi
镑	touo
臆	wijy
偃	egjc
蜗	klkt
瞰	mvae
侬	eyry
搡	abbf
郸	ujdc
缆	vnqk
袂	pbte
楮	fhjr
诠	otgn
麼	pvoa
洵	iwjr
犊	wdvg
摹	sjgt
蟀	kovd
邋	vnwp
瓒	gwqk
苻	seac
荦	sywn
竣	ivte
骥	xurt
泗	inqr
痣	phyi
贲	dskb
胴	wkfl
潼	iikk
弑	wfgf
匐	wflj
姣	cotw
谤	oouo
蘸	sgwu
蟋	kqpy
渥	ibhk
浒	ioqd
蛐	kksj
阂	poin
糯	pdsr
愠	yjmn
嵇	rdjs
谒	ojwx
绾	vobb
舀	erjk
呤	ltob
噙	ltpv
槟	foet
嘣	ljww
诃	oalv
宓	oyqp
脓	wyry
樟	fijd
忪	ytvv
蛰	ayok
咤	loqa
捱	ashh
阜	ydid
峥	jyxv
濡	idsr
遢	jxxp
瑙	gvrw
碉	dwhl
荃	stgn
孵	toov
讹	oeri
嗵	lbtp
彝	bpbs
颀	edkb
苓	stob
咝	lvvs
篆	qbds
臾	rtej
椭	fcsw
沏	iabd
颦	nmdd
蛆	kmic
淆	iwsw
揄	atfm
嗑	lhvm
辎	hvjt
踮	numl
犷	ruuq
鳅	qruo
荔	sxxx
會	tfjj
闫	pfan
徵	rfgn
隗	cwuj
渤	idyx
馍	rsjg
锏	tpjr
楣	fbmf
蜃	skcn
遛	tjpd
倌	eobb
氤	qngd
戌	dfiw
嶙	jpra
馗	yutk
匮	glkk
揶	aacj
胚	wdfi
啻	ouyl
敕	fleh
夙	qfrk
锹	truo
珈	gxlv
跂	ndbu
摒	abus
迩	ympd
啾	lruo
峪	jttl
靼	gjfi
蓟	sqmd
菠	sivp
沅	ifhw
馥	rjqe
槌	fypd
燮	uuub
為	owwd
褛	ppcn
贻	kvlv
豚	wdsy
礴	dsia
氲	qjmn
湍	ijsr
腌	wgkd
蚱	kqmo
殡	frot
毗	jrri
耙	dtcb
诽	olia
褴	pnqm
恁	eeyi
呷	lkjv
蚌	kdnc
瘁	potd
铝	tllv
蔻	sofb
憩	rtyi
锚	tsjt
濑	iflk
耘	dtsv
俾	ewdi
鬃	hohs
裟	imqr
祢	hyma
苒	skht
蘅	srqa
鱿	qdoy
唷	lovw
傥	enqr
袈	xlor
豺	yaqp
町	jant
掇	abbb
坯	hdfi
阏	pots
戛	dmgg
贮	kofi
塾	ovyh
剽	dhmd
孬	dcvk
衩	pbod
镣	tgum
戊	dww
犟	vlkw
酉	goo
夥	jfrr
斡	djtd
過	npda
匝	gmvf
珩	grah
诘	ohlv
攫	ammb
潢	iskt
黔	ntov
臃	wovw
罂	kkwo
轼	hgfo
酗	gwxg
嘹	lgum
時	jhac
阪	cebu
璎	gkkc
冗	yqjm
桧	ftsv
闳	psvv
皿	mnn
囡	ncnw
辍	hbbb
觎	tfwk
浚	ivte
闰	pgnn
臼	rjj
蹩	umtn
煲	elfu
怵	yfod
囤	naxg
罔	kuuw
蚓	kvns
碴	dfjf
姒	cxot
灸	youo
蚯	kefi
嗥	legd
堑	heht
箴	qdfl
谗	oyls
嵘	jsyf
箩	qmrk
艮	vnn
碱	ddfl
葆	self
還	mflp
旎	oqbr
谆	oovk
粽	pohs
牒	thfv
泸	imbh
蔺	spwi
刽	tsvm
锷	tlls
诋	otao
惇	yovk
缜	vdmt
爻	wwll
贰	gskb
坳	hvxk
睑	mtfi
葭	sbsb
昀	jwsi
經	bfvf
妪	cgwl
噫	lijy
镂	tpcn
癸	bfgd
沣	idns
笆	qcbk
壬	enn
绉	vyxl
抨	ahue
箕	qdjk
叵	glvf
坨	hori
颉	hldk
姹	coqa
赳	dxgk
琮	gohs
焊	ujhg
纭	vsvv
淬	iotd
埠	hydi
泱	ikgd
恹	yssq
淙	iohs
榛	fgrh
酵	ghvk
銮	pwji
孛	dyvk
嗳	leyb
佶	ehlv
犒	woln
茱	swti
饪	rens
孪	pvki
泠	itob
砺	dsfw
遽	mdpd
嗟	lufo
钙	tafx
鲲	qjrr
谚	oiqt
闾	pllv
谟	osjg
馊	rrnb
翦	uwmx
雉	qwii
虱	vqkc
糠	puxk
锴	trre
赈	ksnb
旮	yjrf
骠	xdhs
峋	jwjr
跆	nvlv
飛	bkk
瘠	pssw
潸	iffw
饕	lsmy
佚	eqgu
淄	ivjt
谀	orte
镳	tiuo
廿	sfij
喟	ljwy
偻	epcn
绺	veml
沱	iori
囱	rehn
铳	tovq
袤	ocqr
兖	otvq
對	kuac
栾	pfvi
诌	oyxl
畿	vvgj
赓	uxtk
苯	sffi
佻	eqss
繇	ewqb
魈	wmwy
屌	blmv
谲	ocql
泾	ibfo
獗	rsue
鞅	gkgd
蹶	nsue
绔	vgfs
雹	dwck
旯	jyfr
洱	iars
樣	fuok
馄	rjrr
粲	mrbp
哂	ldxv
蔗	susu
饨	raxg
奘	xhgd
芍	swod
淞	iftv
腴	wrte
現	gmxn
剜	orvm
汾	itbd
顼	gdkb
濂	iuut
蜚	lkci
殒	frlk
麝	iwac
鹞	ewya
蚤	bokc
浃	igue
坂	hebu
颚	llfk
忤	yqdi
洙	iwti
祗	htao
無	qsfu
迤	qcpd
眦	mnri
彗	ddxl
暹	jwpd
赧	httb
佝	ewlv
蒯	swwm
郦	fkkc
僮	eikk
钺	tgxi
嘞	lgxk
硅	dhht
玳	gegy
蛹	kbtn
睾	qmhd
赁	eekb
螭	kpxv
盂	famn
瑁	gksm
俅	efko
侗	ekfl
骛	cqex
宕	odhb
纂	qmgb
堰	hgjc
厩	sxvq
萋	sdxc
鄢	fnsc
帔	mvpv
蓁	sgrh
杈	fbod
熨	bhau
挞	agpd
阗	pdmt
觐	gskx
開	kfsj
钏	tqcj
煊	uoff
泫	iovo
迳	bfpd
缮	vuul
夔	utne
燧	uudp
嘁	ldkm
孱	bvvv
懑	isfy
邕	vlcb
彧	glft
柩	fgyo
耆	hrjr
漕	isjj
鹄	wlya
龛	ydqp
饯	rfgg
餮	frty
幄	mbhk
鹘	myag
爰	ehbu
噻	losh
倨	ebdg
汜	icks
诙	osuo
锃	tlgn
颧	sllk
璟	gjom
纰	vrri
绡	vmwy
鏖	iwjl
瞭	mgum
氢	qbfo
颢	jomk
楔	fdbg
藜	srwk
郢	lgcj
妫	coxo
栀	fefv
岫	jkos
谥	outm
骧	xolr
犄	wgal
葳	sdfc
辇	gghc
珪	ghht
璜	gskt
魑	wpxv
聒	arer
椿	fgjr
谩	ojmb
伢	ehye
琊	ghcj
骅	xerd
禛	hdmt
鹜	cqey
闩	pfin
颍	rkdk
翕	yxxi
濠	iods
仞	ebod
鳗	qjmb
玖	gyod
踊	nbtn
皈	eebu
痿	prcn
骊	xfkk
芑	sbjj
孑	vfil
檄	feoe
帼	mngo
撸	aqjr
啵	livp
昶	okjr
柚	fkov
祐	hslv
篑	qlkk
陲	cesj
潋	itfe
亟	vlbf
樽	fuga
锺	twkk
遨	hwep
莆	sfuj
舶	qebo
蛀	kogn
琨	gjrr
點	nmlv
邈	yeqp
棂	fxuo
抻	akeo
搽	astf
俪	efkk
铉	tovo
怩	ybri
嚯	ldwi
茁	sxxg
韭	lfii
膘	wdhs
酩	grlv
榔	foxc
娩	cylq
忸	ybci
刎	wtmd
彿	rvti
扪	apno
漳	iijd
瑄	goff
呶	lcbu
仃	eane
呯	lhue
佞	escn
饬	rqxk
裨	pwdi
壹	hyfu
巽	ccst
黜	nxxg
鹂	fkky
滂	iouo
徉	rugc
戕	xggp
埂	hfjw
倢	efxn
僖	ehll
纫	vbod
奂	ykgd
溉	ixvq
範	qgvi
猊	rrqr
胛	wkjy
卟	lmov
锌	toxj
遑	egpd
跻	npti
珣	gwjr
妗	ctov
蒿	solj
钛	tgod
岷	jcai
葩	secb
傕	eywi
磺	dskt
魃	wsbo
汕	ijss
蠡	bdkk
苋	skxj
剎	wfom
肛	wfoy
潞	inel
阕	pbfg
铤	texn
桠	faue
涿	idod
薜	sblo
郃	ycje
氐	taod
鲛	qotw
睥	mwdi
滦	ipfv
稔	rtoy
頭	flum
妺	chon
锲	tdbg
徜	rnsc
哙	ltsv
冼	swqr
獐	rijd
讧	ofoa
喙	lbds
氨	qocn
缯	vujj
赊	kths
褓	pelf
菀	sorv
鄱	qpjc
炅	juor
碜	dvgt
戗	tvgg
嫫	csjg
瓴	toba
犍	wxax
酊	gano
臌	whlb
螓	kgrh
钠	tkte
镌	twvj
麗	fkfi
铀	tkoj
羯	ujwx
挝	aapd
谡	ojte
襁	pvlk
邙	ucjw
渚	ihjr
胫	wbfo
箸	qhjr
逖	rupd
雎	mwii
砥	dtao
衢	rmma
狒	rvti
骞	ostx
荟	stsv
汛	ivdi
盥	rkmn
睚	mshh
栎	ftma
祚	hqmo
砣	dori
烩	utsv
氣	qpmq
夯	gxkd
拮	ahlv
驷	xnqr
掴	ango
蘩	sqbb
禩	hjst
蜞	kdjc
乜	cyyy
殓	frti
灏	ijok
發	bvqh
擢	axxw
哔	lrrd
殛	frvf
徇	rwjr
荪	svma
蹴	nomd
疹	ptto
谯	owuo
鸵	yori
忾	yqqi
韫	avjm
祛	hhvv
膻	wonf
黢	nvte
仄	steh
炁	gquo
唳	lisq
烊	uugo
孀	cdfm
斫	dejh
腚	wofn
牍	tdvg
佃	ejte
懋	fcqy
赡	kysu
鹗	llfy
秣	rhoh
榷	fywi
镭	tdjt
庾	urte
铄	ttma
媾	cskh
嫒	ceyb
饽	rdyv
佥	tfis
谌	odxi
尕	vmaj
啮	lntx
蝼	kpcn
闱	pavi
逡	vtep
篙	qolk
膑	woet
問	klvn
荥	sykv
隍	cegn
蕨	ssue
罄	hbqw
郓	yhcj
囵	ntri
橹	fqjr
诰	owlv
睢	mwif
蹇	ostn
喱	lskk
縯	boft
間	kjrn
話	urea
肓	uwyw
榈	fpll
绶	veyb
槊	uxwf
罹	mywi
瑗	gehb
槁	folv
秸	rhlv
裱	phry
荑	sgvg
牦	wrmn
滓	ioox
腓	wliy
砝	dhvv
舐	rtai
谶	ottf
嗎	ldmv
秆	rhgh
荏	seen
芈	saoj
邝	ucju
斛	ytsd
給	byes
暨	xvgf
狻	rvte
滟	idyc
恫	ykfl
纾	vcus
麋	ipml
锟	tjrr
粑	pcbm
诳	orgn
氅	nerm
寮	ogum
鹑	ovya
驽	cbxm
囫	nwto
炷	uogn
缙	vauj
徕	rfpm
弭	varg
聲	hbqa
橇	frrr
痢	prmd
柑	fssi
圜	nmfr
撺	apln
魉	wfkt
儆	eswe
妊	cenn
婳	cfjx
兩	fmrr
矍	mmwb
犸	rxmq
哓	laqh
酶	gqbm
當	njts
庖	uwck
缢	vutm
俎	ttmi
墉	huxw
鲫	qxvx
藓	squg
佰	edjr
痔	phac
觥	ytmh
哞	lvwn
闇	kijr
旃	oqwo
讓	uolr
伉	eoqj
猷	ugsq
怄	ygwl
牯	wdgn
茀	svti
烜	ufjf
锨	teei
長	haa
豢	ugds
轱	hdgc
泵	dkvh
蝌	krsd
擀	adjh
绻	vugv
呔	lgod
绌	vxxg
蓑	sofr
釉	qpko
纥	vqvi
翳	gqqx
殁	frqh
讫	oqvi
濛	isyd
從	rttn
蜇	aekc
砧	dmlv
殄	frtt
萼	slls
辔	vhvl
覺	rwwm
诮	omwy
胰	wgvg
浔	ixac
蜍	ktff
緂	buuo
瘌	pflm
趿	nvod
钜	tgbu
瘀	pots
鸪	dyag
霰	dswe
婥	cmjd
赟	pfgk
邊	tpop
祇	htai
鹧	usfy
诨	oyhc
掼	abdk
僭	egqj
礽	hvjs
動	wkxk
弁	vsjv
體	mksu
湎	igis
汨	ijrs
栉	fsxj
蹉	nufo
醍	gjfn
磬	hbqd
铂	tebj
泷	idqp
蓼	sxxt
梏	fwlv
祜	hdgs
摺	axxe
鸩	yqya
虺	hkcw
豌	fluv
疡	pvto
嘬	ljab
杲	jfvr
荞	seti
煨	ujgf
蛔	knlv
涝	isyx
焖	upyi
祉	hnis
魍	wkuu
锉	ttth
跎	nori
桎	fhkv
诿	orcn
娠	csnn
喆	hlhl
瓯	gwaw
偈	ejwx
殚	frud
镁	tugd
邳	dfcj
痂	pxlv
胱	wmhw
刍	yxlm
醐	gdwy
糅	pcqf
亞	fjai
岿	juxl
愎	yqje
赝	sewk
禇	hhjr
唁	luav
笳	qxlv
崂	jsyx
齑	ptlf
狎	rkjq
踽	nqkk
鳍	qhrj
揆	abfg
钹	tsbo
侩	etsv
帧	mmkb
裾	pbdg
椁	fovk
姮	cfjf
唿	lwty
種	rwkk
澍	ihla
崧	jftv
淩	ihte
衾	tovr
骈	xusj
仟	ewke
勖	ksmx
咭	lhlv
谪	ooud
羸	uugw
柁	fori
狲	rvma
窣	potd
槃	qqfv
珲	gyhc
蛭	khkc
痍	pgvg
猢	rdwy
俦	edac
镫	tbfu
鼹	rbjc
戡	dxgg
悌	yuvq
嬅	cshs
濯	ixxw
懔	yonh
莅	seid
裡	pkky
肊	wviy
咩	lugv
誊	ugua
鳝	quul
見	mxx
卻	ttlx
韪	jfnv
亓	faji
铩	twfv
噱	lmds
嫪	cxxt
燏	ucql
俚	ekke
硌	delv
椤	fmrk
臉	wrly
脍	wtsv
炘	uejo
淖	imjd
汞	fkvo
姘	cusj
聩	alkk
泅	inte
喑	lijr
铡	tkmd
绦	vefv
桫	fimq
恽	yyhc
薏	sijy
遒	ugpd
痨	psyx
屙	bcal
蚪	ksdi
佫	eelv
窸	pqpy
蒺	spqi
蚡	ktbd
觞	ytqt
葺	slar
煅	uefq
茕	syvd
悱	ylii
肜	wtoy
沨	iqwl
棫	fglf
靛	hwon
诓	oggn
拋	adxk
忝	fgmo
箔	qieb
璠	gqpj
芃	sqod
別	lwmd
珥	garn
菅	sobb
嶷	jrqn
酃	dllc
與	rskt
臬	tfvk
岬	jkjs
舢	qjso
肱	wsvv
焙	uilv
逦	fkkp
啖	luuo
冁	ujdg
鸷	ayoy
蜢	kvmn
莠	srvj
級	bvod
茔	syht
铨	ttgn
槚	fdkb
胺	wocn
旻	jpwr
雲	dsvv
變	ubbe
堇	gsie
艽	syfj
湟	iegn
瑭	guxl
踅	aenv
芨	svod
嶂	jijd
逶	rcpd
幾	vvgt
钾	tkjj
跹	nwpd
徭	rewo
鹌	gkya
狍	rwck
笞	qvlv
埙	hlkb
仵	eqdi
缛	vsac
椽	fbds
暝	jyjt
苕	sblv
酮	gkfl
婺	cqec
貉	yelv
玠	gtti
囿	nswy
糨	pvlk
畹	jorv
铖	tdvi
帏	mavi
镝	toud
缦	vjmb
铣	twqr
轸	htto
將	xwac
舂	grju
碘	dkst
黍	rtkv
芫	sfhw
馔	rcct
铢	twti
碁	ddhj
槿	fgsi
赭	httj
涪	iilv
塬	hsem
氯	qxkv
倬	emjd
酡	gori
實	obdm
颏	odkb
傣	egkv
媞	cjfn
缱	vlkp
浜	ieft
暻	jjom
篾	qmdo
鋆	hwsw
柘	fdhv
猕	rvym
桉	focn
砒	drri
邶	urcj
洌	ifrm
衿	ptov
颛	jsdk
蜮	kglf
骢	xrey
柒	iafv
呖	lsxk
郅	hcjk
饴	rvlv
圩	hfau
茯	sesq
疱	pwck
圄	nfcl
橐	dlyf
琚	gbdg
钿	tjtj
貅	yefv
枸	fwlv
蛎	ksfw
嫱	cdul
爿	xpp
進	wpdi
辂	helv
綦	dbsj
唢	lmkb
笤	qblv
旸	jvto
鼬	rbko
苜	smfj
窠	pjfv
嗄	ldme
卅	sjjj
苡	sxot
茏	sdqp
艄	qmwy
囹	ntob
辚	hpra
撷	ahlk
伥	ethe
毐	hbso
骓	xwim
疟	pxlb
筌	qtgn
屐	brdb
靈	dllt
猁	rrmd
傩	ebwi
疽	pmib
帶	sfym
貊	ydjr
珙	gsti
诟	oefl
鼐	vmxt
剛	kujm
鬣	hvnb
獭	rflk
嗞	luvv
獾	rslw
洮	iqss
邛	fcjo
赅	koib
黒	kuok
擤	atja
稗	rwdi
咴	lsuo
楂	ffjf
氮	quuo
竽	qfau
箓	qxkv
勐	vmxk
碣	djwx
谔	olls
逑	fkop
铧	terd
郾	gjcc
師	yfmv
铆	ttmj
褡	psye
滁	ictf
陂	cvpj
喁	lkyv
矠	cqsj
湫	iruo
蚺	kkht
钨	tewj
钲	tfni
綮	iebs
蕲	suje
噹	lnjt
遴	prap
舛	raok
荠	spti
玕	ghgn
稞	rjfv
阄	pykd
荚	sgue
媪	cjmn
鎏	iovw
迡	brpd
悒	ylcb
笏	qwto
晷	jeml
郗	wsmc
戰	lljg
宥	oswy
豸	ykk
摈	aoet
儋	eysu
葶	soan
瑸	goet
愛	eyye
凫	yqja
阡	cwkj
猗	rgal
粕	pebm
蚨	kguc
纛	hbmb
畲	thjt
睇	muvq
難	sflw
洇	ingd
滿	isfr
裏	okry
醮	gwuo
癣	pqug
虢	eamu
龍	iwmo
葻	srfj
诒	ovlv
酆	jddc
內	kruf
踯	nugc
珐	ghvv
颎	rudk
馏	rtjt
髭	hnri
莛	sexn
龈	ntxv
锒	tovn
钯	tcbj
楹	fvbm
贽	ayok
菖	sjjr
虻	kuwc
灞	idgw
苌	sthj
聽	agdy
躅	nmwk
牝	wrin
钎	twkj
畦	jhht
珺	gxql
欤	sfei
桁	frah
腩	wdkd
該	uoia
吖	luns
屍	bfrr
蠹	dlyk
眬	mdqp
張	vhag
夢	smyr
瓤	olsq
鸶	vvya
淝	iwcb
亳	oqai
應	uewy
楫	flar
薨	smyr
祂	hcys
訇	wuay
镊	tabb
陟	cnma
炰	wcuo
靜	hwev
镗	tnht
樗	fdfs
苫	smlv
阆	povn
莒	sllv
罅	wmqa
稹	rdmt
豕	dss
涫	iobb
螟	kyjt
骝	xtjt
連	gpdc
蓿	soej
祧	hqss
苎	sofi
擘	blot
玎	gann
犴	rhgq
侉	egfs
學	rwwv
仝	tfoe
厝	ssjr
馐	rubc
潍	ivwi
邰	vlcj
兕	khwf
赍	dttk
龅	ntxc
黩	ndvg
霂	difv
胪	wmbh
诤	oyxv
抟	asxo
鬈	hugv
結	bhlv
烺	uovn
裝	xhor
芪	stai
莳	sjac
毽	rxax
筇	qfcj
忺	yeii
猞	rthl
砭	dqpe
腱	wxax
澧	iksu
挈	dbtu
镞	toqq
怼	bayi
嬗	conf
貔	yrwr
醴	gksu
搠	auxw
杷	fcbv
薹	shlh
杌	fhwv
並	ukge
風	rff
讴	ogwl
铬	telv
闼	pgpd
拊	aeac
歃	wrei
機	fvvt
輕	gfvf
蝮	kqje
沆	ioqj
晞	jwsm
飏	qwvt
烷	uofh
箜	qpfo
彀	hfvg
雠	wowi
傳	egac
揿	atei
荩	sbos
恂	ywjr
燊	uuuf
茴	snlv
癯	pmmw
吔	lcyv
國	nglf
備	esqt
闿	pjbj
衽	peny
鲈	qmbh
紅	bfos
缟	vols
昴	jtmr
圻	hejt
廪	uonh
垓	hoit
瘙	pbok
奁	ggwl
痫	ppfv
黟	nrrk
讦	ohga
矾	dqod
葉	shfv
铰	totw
氖	qvjq
烯	uwsm
陉	cbfo
妯	ckon
耄	hrrm
強	vvkc
菟	sylo
踟	nqlv
镛	tuxw
鲧	qqbs
镱	tijy
峄	jbao
竦	iflv
搦	avss
飨	vqys
鳏	qmkv
吡	lrri
猡	rmrk
痼	pndg
讣	omoa
荭	svfo
龢	yllr
殺	wfqh
馕	rdlr
鯶	tygc
枰	fhue
黼	kumf
檫	fowh
氂	hesr
鄯	uulc
酽	gauq
鲇	qmlv
垅	hdqp
歙	yxxe
骘	cnmx
佤	eawe
頫	qssm
妁	cwod
垩	auht
處	meqj
蠃	ukcw
锆	twlv
枇	frri
鄞	gscj
乩	mlxi
幂	yjgm
遠	hlrp
場	hjft
蟊	cqkk
沭	ifod
垭	haue
綪	bhwy
鹳	slly
萁	sdjj
伧	etvi
苁	stte
恚	hhyi
盱	mfau
鼋	fhlk
钤	ttov
門	knn
矬	qtth
帑	cbmv
關	kvvx
劍	rmdl
兒	rqrj
車	gcc
轉	ggac
離	pxkw
溦	ijfe
侪	epti
穑	rdul
極	fvlf
脶	wlkt
煸	uinc
娌	ckkn
砀	dvto
陣	cgcj
孳	uvvv
蚋	kkte
吶	lkru
缁	vvjt
脔	pktt
箬	qssl
豔	jddm
颙	kdkb
樯	fdul
麂	iqjl
糸	bss
猱	rcqf
跸	nrrd
甑	ujua
岈	jhys
掮	aiwy
榘	qgbf
龃	ntxm
芾	sfmv
沔	iaxv
炆	upwo
趸	fwnv
涘	ivqi
蹰	nsfa
苣	sgbu
冄	ksif
裢	phpd
萸	srte
郧	lkcj
嫇	cyjt
捭	awdi
緊	sbbs
謇	ostu
湉	iyre
笫	qqxq
雖	lkwi
枞	ftte
妣	crri
禟	huxl
疥	ptti
啁	lwhl
氰	qhwy
蒹	suxt
驚	swld
誰	uwia
檑	fdjt
莴	slkt
禳	holr
缌	vjyi
婄	cilv
夤	roft
鹬	cqky
勣	hmxk
終	besi
镏	ttjt
玢	gtbd
狯	rtsv
馬	dmm
傢	eods
焐	ufcl
縻	pbsa
屃	bkbh
莜	sene
魆	wgxi
腭	wlls
鲑	qhht
淦	iwjs
洹	ifjf
砦	nrdh
荇	srah
鲠	qfjw
楝	ffnu
榉	fita
蚝	krmc
楸	fruo
艨	qsyd
鹈	uvny
棹	fmjd
睃	mvte
昇	jqsj
瀣	imrf
東	fjrv
鬻	vpvn
龉	ntxl
庥	uefv
骐	xdjm
囗	nww
筢	qacb
柝	feod
靺	ghoe
膂	oqrw
磔	draf
柞	fqmo
堀	hbxx
谘	osel
鞨	gjwx
锰	tvmn
泔	issi
協	dxxx
聃	akht
徂	rmic
堞	hhfv
蟥	kskt
羕	uokv
墀	hbkw
薅	scsa
呎	lbod
嵯	jufo
怿	ybao
艟	qikk
窳	pqqu
蛳	kufm
彘	brqr
迨	vlpd
犰	ryfq
篦	qrwr
跶	ngpd
橛	fsue
荜	srrd
焯	umjd
儁	ewkf
趺	nguv
倥	epfo
鸹	ryae
瞇	mppd
椋	foma
崃	jfpm
芩	stov
旒	oqoq
記	ubja
芡	seij
請	uhwy
耧	dtpc
蝺	kqkk
庠	uugu
侂	euqa
眾	mett
钴	tdgj
狴	rrrh
镕	tptl
樾	fdgx
欸	vqei
穰	rolr
螯	hwek
耒	dtin
眙	mvlv
罴	mhvu
菈	said
隨	csfp
肄	rqxa
缃	vfmf
怛	yjfi
逄	eapd
哏	lvnv
岙	ejso
沤	igwl
珰	gmxl
荨	sxac
圉	nhud
娈	pcni
叻	lxkv
訢	ueja
耋	hrhk
鸮	lsya
雙	wwbu
邴	fktc
擊	gxqt
毂	hhcf
俳	elie
傷	eqjt
铱	tory
艏	qutk
喈	lrre
類	psdm
蓠	spxv
薮	spce
崤	jwsw
貘	ysjg
峤	jeti
珮	gqfm
笄	qfsj
蹁	ninc
缗	vcaj
蕤	sdwg
條	enef
渑	ilkd
掾	abds
秫	rfod
璁	grey
吋	lacv
祆	hfgd
豉	flub
醪	gxxt
郿	bmcj
搧	aixx
庑	ufdo
茛	svnj
莼	svax
挹	alcb
筮	qftt
媸	cxfk
阒	pmsq
怫	yvti
鲔	qswy
許	uqdi
認	uboy
疣	pdob
雱	dogy
姰	cwjr
團	ngac
镍	ttfv
褫	pemu
轳	hmbh
锛	tgds
潾	ipra
鲵	qrqr
萬	skyj
熵	uoul
錯	wsjr
謝	uwac
馑	rgsi
眇	mmqp
瘆	pvgt
電	dkdy
轺	hblv
塄	hmog
續	bhmm
纔	bylo
涞	ifpm
杼	fcuv
讬	oqai
沖	ilns
崮	jndg
岘	jkxs
纮	vsvv
镢	tsue
诂	odga
玦	gbte
鲶	qtoy
氟	qvti
鲮	qhte
蔌	sfle
鐵	wdgg
椹	fdxi
洄	inlv
僜	ebfu
栊	fdqp
沴	itto
郏	gucj
孢	vwck
郴	ffcj
侑	eswy
獬	rytw
澶	ionf
詈	muaw
興	rkft
箧	qggu
語	ufcl
朮	fodv
嗐	lodl
鳃	qjyi
線	bekv
讵	ogbu
矸	dhgh
璺	rkfo
枋	fogv
啭	lhso
幫	hham
鞣	gcqf
澌	idej
黻	kumo
蜉	kevk
鳥	roo
耦	dtky
樘	fnht
虛	mxfi
跖	ndhv
蛉	ktob
箪	qujd
歡	slle
扦	awko
逋	fpdu
璈	ghwe
愆	riay
孃	colr
跩	nkqp
鳟	quga
浠	iwsm
泚	inri
藿	sdwi
痱	plib
隊	cuds
憷	yffn
殳	qhh
纡	vfau
葚	sdxi
翮	flkx
錢	wggg
戋	fggi
喦	lllj
黧	rwqn
矇	msyd
鲽	qhfv
诔	odti
絕	bbcb
曷	jwtx
毖	rryq
題	jfnm
髋	mosk
狳	rtff
藍	ssqm
哚	lqfv
坻	htao
槎	fufo
蜊	krmd
乂	wll
铙	taqh
袆	pavi
嫘	cjbs
漯	ijbs
骟	xixx
捌	alxm
瓘	gslw
椴	fefq
溘	ihvm
牖	tifu
蹚	nnht
墒	houl
阋	prqr
阇	phjr
愍	caey
龋	ntxk
刈	wmdl
篁	qegn
谝	oinc
樂	evvf
蠲	utmk
悭	ynbh
總	brey
郞	ovcj
鬲	flkn
瓠	gfsq
撄	akkc
畠	ejtb
嬛	cmfr
圪	hqvi
洺	irlv
錾	hewj
轾	hhkc
笮	qqmo
棰	fesj
麸	hegu
杓	fwod
衛	rcah
砷	dkeh
辦	oxox
疴	palv
剀	jbmd
餍	ssys
锱	tvjt
寤	oxfl
瞽	hlum
糍	puvv
芎	svgj
捩	aisq
蹼	nkug
尻	byfh
缡	vpxv
鳕	qdxl
陸	chth
裰	pbbb
偬	ewty
窨	pijr
唸	ltoy
幛	mijd
茑	syaj
榫	fwdi
峁	jtms
蓊	stvx
鏊	hwew
秭	rqxq
屄	bpxh
茼	skfl
瘢	pqqh
鲅	qsbo
郜	wlcj
茝	sscj
芰	sdbu
汊	ibod
旄	oqrm
殍	frev
樨	fbkw
碇	dofn
摭	ausu
涑	iflv
钡	tkbj
蓍	shrj
垆	hmbh
萘	sghs
炔	ubte
蟮	kuul
凼	kxgv
飧	rysk
岢	jalv
俣	elfg
碓	dwih
刿	jrmd
數	ldle
孓	vodl
龁	ntxv
谰	opfu
蕖	sigf
痧	pimq
暍	jjwx
霈	difm
訴	ueod
唵	lgkd
钚	tduj
聖	algn
腦	wvrw
嫚	cjmb
叆	sveb
異	jsti
槲	fytd
铗	tgue
亂	ebkx
绐	vvlv
痈	ptnb
狷	rlwy
媗	coff
埚	hlkt
漸	igej
酢	gqmo
阍	ptaj
梼	fdac
層	bujj
欹	gale
螫	httk
準	iwdi
傈	edfv
榊	fhke
壅	ovqh
渌	ixkv
赀	nrkb
怙	ydgi
癔	pijy
傒	eevg
紒	btti
莪	sqag
冴	shyi
嚇	lhtt
視	hmxs
吽	lwnv
潆	isyb
浞	invs
檩	fonh
镠	txxt
逯	xkpd
腳	wttx
熱	hthu
蔸	setq
痤	ptth
翥	hjxx
嘚	lrja
親	ifmx
毬	rfko
菽	skmb
鸱	taoy
戲	mflg
昉	jogr
盍	hvmn
茭	sotw
酰	gwqr
黥	noma
圍	nciw
珽	gexn
霪	diee
藥	sevf
赉	fpkb
菏	sial
淰	itoy
禵	hjfm
夠	rrwl
诹	oabu
柟	fkht
園	nhlr
苴	smij
粳	pfjw
溿	ijua
滅	idfu
樹	fhla
欷	wsme
復	rqje
糌	pemj
蹓	ntjt
亶	onlf
惡	fjyi
義	uqag
趵	nwod
護	uswb
舸	qalv
蛩	fqok
枥	fsxk
決	ibte
搖	awwo
蕈	sdjd
蘼	spli
娰	cext
襦	pdsr
膈	wfln
畈	jebu
芏	shtj
笊	qekk
燠	urpg
艉	qbrm
阊	pjjr
厣	sskj
鸬	mbya
傧	eoet
艿	svjj
攮	adlr
酚	gtbd
璘	gpra
叇	svxp
塍	wugh
椟	fdvg
厶	vvv
菰	svqu
氦	qoiq
笸	qglv
疸	pjfi
镪	tvlk
禤	hmxx
圮	hbjt
幪	msyd
佈	esmv
醛	gstg
篌	qebq
髡	hhwa
砲	dwck
謦	hbqu
谖	oehb
醯	govm
徼	reoe
裣	ptfi
枳	flti
懷	yomr
則	mmdb
豽	ykte
髫	hblv
蓖	srwr
酯	grjr
較	gotw
暾	jove
訾	nrua
勢	hthx
確	dywi
趕	djhg
繼	bvvx
缳	vmfr
镒	tutm
碛	dhkb
硖	dgue
孥	cbvk
斷	vvfe
溧	idfv
柢	ftao
镬	tswb
糁	pvgt
卺	vkfv
虼	kqvi
皴	vtev
帙	mqgu
箝	qass
軍	ygcm
鋈	iewj
鍪	cqew
蘧	smdp
锞	tjfv
祩	hwti
丌	ajj
樓	fldc
簟	qdjd
鞫	gwua
眭	mhht
溱	igrh
觀	sllm
昳	jqgu
倆	efmr
泮	iuao
棽	fftv
寶	ogwm
窫	pdbg
坩	hssi
鄄	dhcj
嬖	bloc
旉	fogu
隱	cefy
砻	dqdh
隰	cjvu
郯	uucj
劻	ggxk
報	hudb
衹	ptai
廋	urnb
單	lljd
熜	urey
祼	hjfv
薙	sqwi
約	bwod
筚	qrrd
爾	ftmw
朐	wwlv
厓	shht
尋	xfla
愀	yruo
嘡	lnht
識	uijg
墼	gxqh
跬	nhht
毀	rhqh
醚	gppd
鳜	qsue
幹	djth
萑	swij
恆	yfwf
蚧	ktti
缍	vesj
麇	irhl
遄	jspd
姽	cysv
戆	ijey
達	hupd
柰	fhsv
竑	isvv
琤	gyxv
趱	dwqk
黃	sskt
鲂	qogy
湣	icaj
螅	ktyi
壞	homr
禔	hjfn
垸	hofh
細	bjts
玭	grri
態	vwry
裎	plgn
煇	uygc
埸	hjwt
試	ugfo
爔	uurg
槠	fohj
務	cqex
儇	emfr
靚	hwmx
淚	iisq
肽	wgod
卮	efvi
顯	jvvm
顸	hdkb
筲	qmwy
绀	vssi
盉	rmnh
崁	jhei
菸	sots
媵	wugc
倮	ejfv
弐	fgsi
澣	idjh
谵	oysu
岜	jcbs
褊	pinc
帻	mhkb
創	toxm
鲟	qxac
瘐	prte
梃	fexn
簋	qvmn
缵	vwqk
屣	brnn
陽	cjft
礅	dove
墡	huul
缶	woo
矟	cqmw
缒	vypd
鹚	uvvy
亍	ahh
煙	udht
甪	qtnp
塊	hwut
刖	wmdy
鹡	ssty
炻	udho
澂	ijfe
卬	txjm
絲	bbss
焗	ubvl
瞋	mdmt
荽	secn
瘿	pkkc
锶	tjyi
砬	didh
磴	dbfu
鼍	lljk
閒	kwyn
跣	nwqr
練	bfnu
迓	hpdy
況	ilqr
疖	pxjb
閃	kten
鐘	wikk
炝	utvi
擁	aovw
硒	ddxh
啉	lffv
貓	ysjt
汔	iqvi
驺	xyxl
蛄	kdgc
伛	egwl
鞯	gssv
燹	dduo
绂	vsbo
髀	mwdi
禦	rqfh
缫	vvjf
凇	sftv
羖	uqhg
跗	neac
翀	xxln
濬	imym
羏	utog
銎	fqow
銀	wvnj
綠	bbkv
襌	plld
鏦	wrtn
調	uwhl
寫	orwu
唎	lrmd
爲	ewwk
嗉	lhbs
铘	thcj
殂	frmi
眀	mwyf
鞮	gjfn
盡	xfum
饫	reos
辏	hgfg
檗	blof
鼙	hlud
悛	yvte
璩	gmds
純	baxg
彟	xasb
沚	inis
殘	frgg
笕	qkxk
鲥	qjac
煳	udwy
褙	purw
淒	idxc
嵊	jrur
劢	fwxk
尥	dwod
锍	tovq
隻	wbui
轫	hbod
饧	rvto
佾	etwy
抺	aheo
谳	odks
鲩	qofh
書	xhjr
鸰	toby
苷	sssi
棼	fftb
觚	ytqu
媽	cdmn
嫈	uuyc
佺	etgn
熘	utjt
萏	syrj
觜	nryt
羝	utao
鹕	dwya
睏	mnfv
満	iskj
響	vqoj
剡	uumd
爭	exvi
溫	intm
譞	umfr
喾	iywl
號	lsmu
蘖	syof
狝	ryma
鍊	wfnu
椐	fbdg
麴	dewp
曩	jolr
誗	urmd
砗	dhch
瑷	geyb
髁	mjfv
蚍	krri
領	tobm
阃	pnfv
怱	wtoy
溲	irnb
匏	gfsc
桡	faqh
狺	ruaq
鲢	qhpd
耨	dtsa
煖	uehb
鋹	whaj
傑	eraf
燒	uhhh
豳	jdds
疋	vnfi
愦	ylkk
舨	qebu
缑	vebq
蝾	ksyf
猓	rjfv
搴	ostt
洫	iqmn
員	lmbv
蹾	nove
蚜	khyc
榧	fgli
磙	dotr
螈	ksem
粜	xxpm
坜	hsxk
釐	hesk
荸	sdyv
踫	nukg
轭	hsvi
绨	vuvq
摀	aywo
抔	aduo
珃	gkht
庋	udbu
詝	uoan
魚	tyy
皲	yhvp
胝	wtao
計	udia
犼	rvxi
蕗	snel
铍	tvpj
滹	imqa
麈	iogn
锔	tbvl
蝣	koqv
邗	hcjg
跏	nxlv
習	xxeb
論	utfn
柙	fkjv
寔	ojfn
誄	udti
網	bkuu
鲋	qeac
疝	pjsb
勰	xxxy
鸫	amya
罘	mduw
獍	rijq
浤	iosv
硼	dwwy
鹾	mnwf
笥	qvfl
掛	ahhm
葸	sjyi
潲	irmw
扃	iklv
皤	eqpj
痋	pkcb
鲱	qliy
賣	hmmb
旰	jhgr
燝	ujom
溏	iuxl
險	crlj
憶	yijy
溽	isac
偾	edsk
揎	aoff
伲	ebri
剞	galm
禮	hksu
秾	ryry
锗	thjr
晳	fejr
屬	bkmk
寘	odmt
華	shsj
狀	xsqp
痦	pfcl
漭	isss
悝	ykki
樛	fxxt
桿	fjhg
嘏	dbsb
袢	puao
昝	emjr
礻	hsss
願	semm
嘆	lsfg
鳎	qjxx
滏	itwu
釋	qpmd
咹	locn
廨	uytw
薩	sciw
璔	gujj
觳	hfyt
戢	lagg
桷	fytn
舻	qmbh
黙	ksuo
綝	bffv
羅	mbwi
彖	bdsm
郛	evcj
買	mmbw
脘	wofh
袛	ptao
蓐	ssac
裉	pvny
艋	qvmn
疠	pfwy
嬲	jxcx
綎	bexn
锜	tgal
業	kuti
粝	psfw
獨	rmwk
郇	wjcj
參	vvvt
歷	srrn
蠱	kkkm
鹩	gujy
耜	dtbb
厲	ssky
坼	heod
迴	nlpd
陰	ctov
紓	bcus
髮	hsbo
鹪	wuya
栌	fmbh
埕	hlgn
嫠	hesc
宄	oyfb
砩	dvti
瘊	pebq
尜	mgma
蠓	ksyd
洳	iclv
愔	yijr
廝	udej
埒	heac
铊	tori
筥	qllv
墁	hjmb
脫	wtlq
講	uskh
锂	tkkj
颟	sfkk
蹀	nhfv
蔟	soqq
劬	wlxk
剋	dqmd
曈	jikk
誘	urvj
濞	itja
飄	dhrf
飯	yebu
醫	gqqg
鲎	iyqy
蠖	kswb
唣	leai
係	eqbs
祕	hyqp
悃	ynfv
谮	ogqj
畀	jajt
紛	btbd
咥	lhkv
裒	orry
磾	dlld
訞	ueoa
镲	towh
锝	tjfa
蚬	kkxc
煩	udmb
郫	wdcj
淯	iovw
伕	egue
嗍	luxw
讚	uwqm
臜	wwqk
邡	ocjg
奭	gdjj
螨	ksft
阈	pglf
組	bmis
蟲	kkkc
怍	yqmo
頂	admb
赜	shkb
鳐	qewo
爌	uust
歲	ndfm
鄣	ijcj
歔	mkei
敵	ouke
拶	avrk
嚐	lnrj
遊	oqvp
狁	rvqr
陔	coij
觯	ytud
擺	amvr
矽	drkh
汆	rkvu
呣	lbmv
绹	vwwo
涬	ihud
託	uqai
鹣	uxny
卍	vnfn
卐	xfnf
磲	digf
湜	ijfn
勝	wugx
呒	lfdo
袴	pgfs
钼	tmfj
颡	bbbk
肏	rktt
皞	eegd
換	aykg
齮	mgal
顧	iwdm
蝰	kghh
畋	jeht
搛	auxt
棗	fkfk
彈	vlld
眄	maxv
劁	wumd
冇	skfo
慊	yuxt
肫	waxg
崦	jgkd
貴	lkmb
夾	gtte
瘋	prfb
陳	cfjr
順	qdmb
冏	ktlv
塚	hydo
慘	yvvt
酹	geac
雮	drmy
幷	qhqh
髒	msfs
胼	wusj
簏	qilk
術	rfoa
皝	egmh
脩	enew
瘳	pxxt
蝓	ktfm
锑	tuvq
稱	rekh
暌	jbfg
壓	sjwh
舁	rsjj
佔	emlv
诜	owqr
芗	svqp
尢	dooo
菔	swxb
尙	nsss
選	ccsp
蟻	kuqg
瑨	gauj
墬	cbdh
瞾	mmpf
焓	utol
旆	oqfm
犨	wwwn
胙	wqmo
琍	grmd
愬	uxwy
蒌	spcn
靸	gvod
畢	jsao
癒	ptfy
癡	prqn
浈	imkb
簡	qkjr
颞	abbk
碡	dhbm
缣	vuxt
唦	limq
觇	mlkx
擔	aysu
谠	onqr
楙	fcqf
埽	hxym
補	pfuy
丟	gvvn
聯	avvx
牆	xhtl
衝	rwka
倖	ehud
栲	fhsk
統	bovq
鑛	wust
鞬	gxax
猲	rjwx
芟	sqhj
鲷	qwhl
踔	nmjd
僳	edpm
俶	ekmb
袼	pelv
產	pswg
蚴	kvxk
鲞	ugqy
討	uaca
槭	fdkm
紙	btai
磻	dqpj
呡	lcai
蒉	slkk
哢	lgsj
佧	ekmo
囟	rwln
邠	tbcj
桴	fevk
檠	swlf
費	vtmb
燔	uqpj
狨	rgso
伷	ekoe
飑	qwwc
騙	dinc
鲊	qqmo
疃	jikk
觫	ytfl
骔	xohs
賓	ofmm
俵	ehry
栘	frrk
唑	ltth
幞	mkug
琇	grvj
溴	itsq
誴	uohs
苊	ssvi
玡	ghyn
騔	djwx
鲆	qhue
囉	lmbw
溷	inds
獚	rskt
掊	ailv
骖	xvgt
鮮	tugy
榇	fifv
癜	pbsq
舉	rska
畚	vgjt
堠	hebq
塵	ihtl
浼	iylq
泖	itms
隹	wii
硗	daqh
質	eemb
睺	mebq
僦	eomd
帥	ymvd
哿	xlal
釭	wfoj
硷	dtfi
隈	cjgf
瑠	gtjt
碚	dilv
馓	rswe
盤	qqmn
劉	twmd
沢	ibod
怃	yfdo
罱	mdkd
奮	gwjt
熦	umwi
隳	csfo
側	emmd
戀	ubby
嵫	juvv
僴	ekjr
凊	shwy
篼	qetq
捽	aotd
鐇	wqpj
偙	eoum
揮	aygc
採	aefv
辊	hjrr
呑	elvo
觌	dvsk
區	glll
揲	ahfv
垕	eflh
垴	hpxg
彳	rcc
設	uqha
篥	qdfv
绱	vnss
虮	kqjc
醢	gslm
诎	oxxg
艹	sjj
蟗	dlyk
埘	hjac
昺	jfkt
陬	cabu
祓	hsbo
锩	tugv
弒	wfof
圯	hckt
蠼	kmmb
養	ugov
翚	xxyh
啫	lhjr
羑	uyod
菘	sftv
負	ymbm
糺	bxis
櫻	fmmc
赑	kkkb
倧	eohs
锕	tcal
佷	evne
砼	dtfo
課	ujfv
戥	jwgg
談	uuuo
蚶	kssi
侔	evwn
鳳	qfro
鏡	wijq
藁	sofv
呙	lkte
豬	dhjr
絷	ayob
靘	hwyc
偉	ecie
檛	fnpd
擋	anjt
牾	wfcl
硃	dwti
镡	tdjd
丅	akkk
崐	jjrr
佴	eare
昃	jste
釆	qpmp
籴	rpmu
杪	fmqp
遹	cqkp
瞢	smym
訝	uhya
揠	agjc
弻	vfnv
耪	dtoo
堅	sbht
搥	aypd
缧	vjbs
節	qxvx
鬏	hruo
雜	ottw
淏	ijfg
畫	xhjf
橼	fvbd
騎	dgal
蛶	keac
伋	evod
爨	rkfu
狃	rbcq
蓋	shvm
萩	sruo
诼	odod
須	tdmb
敗	mehb
蕞	sjab
輪	gtfn
議	uuqg
蛴	kpti
驩	dslw
詩	uhac
嗌	lutm
嘌	ldhs
畎	jsqt
楯	fedm
雩	dfsk
頓	axdm
鹆	ttly
顫	onlm
皊	etob
脬	wevk
殭	frff
盪	ijfm
羼	buuu
萊	sdlj
鍼	wdfl
缬	vhlk
漶	illy
圖	nldl
賞	nmbs
叡	myfb
谇	ootd
適	oukp
荛	saqh
奼	cqai
哕	ljrk
驗	drlm
鑽	wwqm
廛	ukth
嚴	llse
埳	hyrj
丏	axvi
狔	rbri
罵	mdmw
廣	uskt
甍	smya
烃	ubfo
氚	qqcq
袷	pyey
懼	ymmw
蒽	sngy
焌	uvte
黾	lkdv
襻	pfwt
緣	bbds
嗾	loqq
铵	tocn
鬯	wxri
濃	ikss
鵰	whlr
铓	tsuw
魽	tssi
躞	nuub
绲	vjrr
價	edmb
説	uulq
岵	jdgs
環	gmfr
錱	wggn
镉	tfln
涼	ioma
诖	ohht
據	amds
氽	tkve
柽	fbht
遘	skhp
責	hmbf
垍	htkt
钣	tebu
豨	dwsm
逭	obbp
麍	iovq
蹤	nrtn
媺	cjfe
骯	moqj
觖	ytbt
崑	jjrr
栱	fsti
莰	shei
漢	isfg
徹	rove
徳	rdmy
禊	hdbg
茌	sehf
圬	hfsk
茍	swlv
疔	panb
潔	idbb
睜	mexv
虿	fwkc
蝤	kugo
刳	gfsm
嗻	lusu
預	cdmb
嫽	cgum
玹	govo
蒼	stol
铯	tycb
慄	ydfv
葑	shha
呋	lguv
秕	rrri
匦	ghyf
圓	nlmb
豇	fluf
堃	ooht
顏	pstm
資	semb
垧	hrnt
洧	iswy
槍	ftol
贇	pfgm
吣	lyiv
蠪	iwmk
婑	crcn
亻	eee
浯	ifcl
緾	bskk
埴	hdmi
跡	npiv
钪	toqj
劃	xhjm
紜	bsvv
窬	ptfm
桕	frjv
倐	eneu
緩	behb
甙	gssi
歐	glle
惝	ynsi
橫	fsst
眚	wmfg
彊	vfjf
崞	jovk
觔	ytxk
臨	sqll
昽	jdqp
憐	ypra
蛞	krec
颃	oqdk
牤	wuwn
薷	sdsr
镆	tsjg
獄	rusq
嫋	cvss
貏	ywdi
蚵	kalv
瑧	ggrh
邧	fhcj
闶	poqj
爛	ukfu
茺	sovq
蕻	shst
騄	dxkv
嫜	cijd
瑢	gptl
蒗	siov
囝	nvkw
紞	byqr
蚰	kkoc
郕	dvcj
嗙	louo
骍	xoxm
罷	mvwr
礡	dsfa
厊	shyh
撫	aqsu
骶	mtao
敉	pehm
呿	lhvv
鳔	qdhs
圹	huut
焜	ujrr
褲	pugc
階	crre
標	fdhs
巉	jylo
幣	umtm
徬	rouo
黹	kumt
畛	jtto
枹	fwck
轵	hlti
霑	diml
鎗	wtol
簦	qbfu
瞀	cqem
揚	ajft
晡	jfur
跦	nwti
貐	ytfm
荘	suhf
湔	iuwm
鲀	qaxg
啍	lovk
燈	ubfu
砉	ddhn
閉	kaqp
聞	karn
歸	ynxm
扌	aoo
龀	ntxr
镚	tjww
溆	itfb
芄	syod
島	rjso
篪	qemu
仳	erri
甾	vjtc
甡	wwgg
觸	ytmk
猃	rtfi
鞔	gylq
硪	dqag
髂	moel
髙	onsl
锘	tssl
啯	lngo
髑	mmwk
潴	irhj
钭	tsdi
枱	fvlv
權	fslw
碖	dtfn
維	bwis
紀	bbjs
蘋	snmm
裥	ppjr
郐	tsvc
瘘	ppcn
湊	igfg
邨	axcj
胗	wtto
宮	olrn
弢	vxbu
肶	wrri
屺	jbjs
垱	hmxl
猰	rdbg
沬	ihes
紮	fxbs
翃	svxx
枵	flsk
衖	rsta
賽	ostm
專	gacc
笪	qjfi
劵	ugxk
伾	edfi
鲼	qdsk
沩	ioxo
翙	jrxx
鲭	qhwy
绁	vhis
甯	oytn
羟	ubfo
镙	tjbs
崾	jdcn
髌	moet
腧	wtfm
龆	ntxl
邏	mbwp
舳	qkoo
溻	ijxx
悫	hyqy
罾	mujj
湧	ibtx
晢	aejr
蛏	kbht
紡	bogs
紘	bsvv
忉	ybdi
遙	wwpd
餵	yjgf
岡	kujs
氵	iss
稜	rhte
笭	qtob
樑	fibf
曉	jhhh
莊	sxhf
蜱	kwdi
優	edwe
勁	fvfx
氆	rukj
竐	iqhd
锸	twrj
爝	uema
爺	twac
鬆	hftv
蹟	nhmb
褔	pflj
钒	tqod
猸	rbmf
蛱	kgue
孒	vfil
敫	eoeh
舯	qlns
罟	mdgw
铫	tqss
巖	jlle
邽	hhcj
笾	qxpd
廢	ubvq
踬	nedk
籼	pjsm
芘	srri
濉	imwi
楦	foff
絜	dbbs
锳	tskg
貼	mmlv
箅	qjaj
岀	jjss
鬥	ndd
曛	jwne
绋	vvti
埝	htoy
钍	thtj
聱	hwea
茆	stmj
炱	vluo
鬧	nomv
谂	otoy
俠	egtt
檞	fytw
顆	jfdm
舡	qfoo
鹁	dyvy
硭	dsuw
沄	isvv
際	cwhs
厭	sjws
蘭	skfu
褰	ostr
栝	frev
菹	simi
矅	mxxw
纩	vuus
楊	fjft
馇	rfjf
趑	dsei
駐	dogn
唪	lgao
烆	urah
霧	dcqx
轟	gggc
搶	atol
鎌	wuxt
饩	rqqs
軟	geic
滾	iotr
詭	uysv
鳊	qinc
屦	brpc
玙	gsfi
掎	agal
撲	akug
緒	bhjr
莨	sovn
鲳	qjjr
円	kksf
謂	ujwy
昰	jfni
棻	stbf
羨	uiei
螽	eskk
揺	aehx
埤	hwdi
濕	ijvu
規	gmxu
喚	lykg
尨	dtoo
莩	sevk
丨	nsss
膚	mjwy
醅	gilv
潽	iukj
偑	erfe
靦	gmxi
昪	jvsj
齁	tjal
瘗	pguh
莸	srdo
钅	tjj
蜩	kwhl
畑	ujto
鞲	gskh
導	utpa
鈺	wgod
枘	fkte
庹	usfo
梿	fhpd
郄	wsvc
廌	isuo
啶	lofn
傉	esac
癍	pgpg
郤	ttlc
硎	dfsm
憑	sdyi
埭	hxkv
髹	hefv
棄	ovsh
燄	yruu
庀	uriu
寧	oyma
冑	kksi
熳	ujmb
淨	iexv
蓮	sgpd
袓	pmiy
暲	jijd
毪	rvwn
載	dggc
悽	ydxc
氘	qtiq
卣	mnbu
湓	itbm
洎	itks
赙	kfac
淿	iemv
顒	kdmb
牽	ovyw
忞	pyiw
辌	homa
栳	fhri
煉	ufnu
襲	iwmr
糵	syop
浍	itsv
紝	bens
茈	snri
鮨	trjr
歎	sfle
顔	iqtm
旡	gqrf
骒	xjfv
擇	amhd
姁	cwlv
笱	qwlv
絺	bwsm
豐	jddu
阌	peyb
搌	absg
災	vuoc
猶	rugo
織	bijg
廳	uagy
跽	nbyi
籐	qwuk
纏	bukh
揸	afjf
埵	hesj
摽	adhs
證	ubfu
菉	sxkv
渫	ihfv
婦	cxym
劼	hlxk
撐	anhy
堺	hjtt
弇	ysje
墜	cudh
犇	wwwn
檒	ffrf
蘫	sism
鬍	hdwy
僰	fkft
婼	cssl
邾	wtcj
槅	ffln
佉	ehvv
慮	mjyi
紗	bmqp
縮	boej
氇	rqjr
觋	fttk
擐	amfr
庫	ugcu
膽	wysu
堙	hdht
撙	auga
噍	lwuo
蹻	nell
汧	ifsj
喲	lbwo
複	pqje
燚	uuuu
颥	dsdk
測	immd
謎	uppd
鴷	frmr
赸	djsk
蘡	smmc
蜎	klwy
緋	blis
鲦	qefv
挢	aeti
寬	osmo
沲	iqcy
凅	sndg
疳	pssi
刂	mdd
桄	fmhw
誤	ulfg
佇	eoan
紋	bpws
揑	arfo
喬	elkl
悰	yohs
烝	vkfu
繞	bhhh
嚭	hlul
瑊	gdfl
劇	mdmd
碕	dgal
譔	ucct
鞒	geti
窭	ppcn
瀰	ivfw
慝	gssy
髊	mufo
踣	nilv
烔	ukfl
燰	ueye
慓	ydhs
兟	wqwq
凱	jflq
灑	ifki
瀹	iyln
薑	sfjf
襞	blor
矧	qvns
韋	cii
紟	btov
獯	rwne
臁	wuut
執	hudo
嗪	lgrh
偳	ejsr
紤	bejs
臥	stec
僅	egsi
扽	aaxg
遺	lkmp
穀	hfrh
觍	kstk
榱	fofr
蒇	sdkb
刭	bfmd
钋	tmoj
拏	cbtu
唛	lheh
苤	sdfi
艴	vtyc
蛘	kugc
眛	mhef
紥	axbs
暠	jolr
钕	tcnj
損	almb
玗	gfau
揾	ajmn
攉	adwi
雞	evgw
廆	uwuu
氩	qaue
澐	idsv
毹	tfwr
黪	nvgt
遞	empd
岎	jtbd
勗	jmxk
垡	eght
昖	jtvv
骀	xvlv
缂	vges
菑	svjt
綨	bdjs
慣	ybdm
玘	gbjn
紣	bydi
璝	glkm
闆	klll
窅	pmfx
乇	qaip
坰	hklv
怾	ylti
飖	ewqw
锇	tqag
肟	wfsk
鬷	flke
鳇	qegn
瑎	grre
霨	dbha
嫄	csem
詧	wuay
禎	hmmb
財	maqp
哌	lery
仡	eqvi
囂	lldl
韂	gysu
雋	wkfi
鷺	nelr
籀	qatj
蜣	kuxi
錄	wbkv
瘰	pjbs
慾	ttly
讀	uhmm
薤	sfrf
憂	dwye
蕩	sijt
噁	lfjy
嘗	nrjr
砟	dqmo
辻	dpdi
髠	hqja
鐮	wuut
痩	pkbu
傭	euxw
榮	uuyf
牂	xugp
搿	tytu
嵛	jtfm
僬	ewuo
寀	oefv
瞞	msfr
鄉	vqoc
蠛	ksmo
墮	csfh
曐	jjjw
捲	augv
惣	wwty
詠	uokv
孫	vqbs
瓿	ilaw
誷	ukuu
劓	tjam
槔	fegd
瘛	pdby
崙	jtfn
愰	yjmh
頵	xqlm
峣	jaqh
锓	txyb
倓	euuo
鋪	wfuj
煺	uvpd
礦	dust
滠	iabb
忭	yomo
壸	hyau
垌	hkfl
暫	gejr
紦	bcbs
蛲	kaqh
嘧	loyj
袪	phvv
鏐	wxxt
凈	sexv
龠	ylln
陴	cwdi
蟛	khlt
辋	hkuu
俜	eksk
騰	wugd
鬚	htdm
洤	itgn
龐	uiwm
唄	lmbv
獴	rsyd
咵	lgfs
蝥	cqek
猇	rmuq
腠	wgfg
堋	hwwy
儀	euqg
擾	adwe
蓂	syjt
稆	rllv
詟	dqua
轹	htma
汍	iyod
镘	tjmb
柃	ftob
黉	iyst
浽	iecn
詞	uvfl
襕	ppfu
氾	ivis
齕	mqvi
咈	lvti
鞴	gsqt
燿	uxxw
殪	frhu
兇	wxqr
筆	qxao
蝟	kjwy
騦	djyi
杩	fxmv
旛	oqqj
胍	wquy
掙	aexv
唼	licn
穩	refy
巿	fmvi
篍	qruo
骱	mtti
罃	uuyw
娡	chyi
贠	vkbv
躍	nxxw
捯	ahmd
跫	fqon
酾	gfkk
職	aijg
餘	ytff
恧	syir
垚	hhht
蒡	souo
凵	xgg
烀	uqua
碼	ddmh
鄠	dfsc
噴	ldsm
壯	xhfp
忮	ydbu
輩	lgci
瓖	golr
跘	nuao
鰸	tgll
檔	fnjt
滲	ivvt
胲	woiy
硐	dkfl
氍	mmwr
輸	gtfm
遲	bkwp
箢	qorv
嘢	lkcu
罞	mcqp
芤	svxi
岺	jtob
攧	admm
苾	syqp
灣	iubv
痖	paue
踰	ntfm
哳	laej
伱	etma
瘮	pvvt
饔	ovqy
枬	fwob
紹	bblv
諲	udht
檎	ftpv
橦	fikk
嘯	lxtf
鲡	qfkk
蠍	kjwe
狤	rhlv
砑	dhyh
營	uuyl
囧	ntkf
齊	ouns
顗	jflm
戽	isdi
嚥	lsfu
纻	vofi
枊	ftxj
蚑	kdbu
峧	jotw
廁	ummd
盜	iemn
漎	irtn
钬	tuoj
翛	enex
穸	prkx
晹	jjwt
唻	ldlv
瑱	gdmt
饣	rss
墚	hibf
針	wdij
洨	iotw
甏	hlua
氡	qesi
苘	sklv
鳴	lrov
寢	oxxb
諸	uhjr
枧	fkxv
毎	qbdi
鹨	xxty
骺	mefl
麵	degi
瑯	goxc
谞	ovnw
髎	mxxt
丒	bofi
頉	ndmb
媩	cdwy
尷	dsqm
獸	lljs
軀	wgll
毵	vgtr
镟	toqn
瘼	psjg
凜	sonr
桤	fjbj
觏	skhk
嚄	lswb
糈	pvnw
俫	efpm
傾	erdm
峎	jvns
苶	stma
酲	glgn
岣	jwlv
喨	loqj
睱	mbsb
肷	weiy
楱	fgfg
铦	trej
嶲	jwkf
帯	sfym
曌	jwpf
麿	pllv
蕬	sbbs
積	rhmb
柺	flxk
辒	hjmn
挻	aqnx
憤	ydsm
扞	ahgo
煐	uskg
裼	pjwt
鑑	wsqm
農	kssn
鲣	qnbh
铒	tarj
黡	ssne
塼	hgac
餓	yqag
戶	ieee
葇	scqf
酎	gaco
笢	qcai
湲	iehb
啟	ileh
懲	rfgy
熺	uhll
帳	mhav
蛑	kvwn
酐	ghgo
鈴	wtob
埜	ffht
潵	iswe
痲	psia
坫	hmlv
額	oelm
毳	rrrm
夬	bteu
靣	dnlv
铪	tyej
贶	klqr
獎	xwas
钘	tfsj
伹	emie
胂	wkey
紕	brri
閻	kyrj
蕡	sdsm
贏	umbw
滉	ijmh
躜	nwqk
匚	gff
锊	teac
渖	ioke
玱	gtvi
泺	itma
妘	csvv
摛	apxv
勔	gxki
訚	puan
烋	efuo
構	fskh
肅	xtxf
舴	qqmo
犭	rqq
舺	qkjo
鎚	wypd
諾	ussl
袝	peac
孖	vvkk
趼	nfsj
嵴	jssw
悶	kyin
擗	ablo
疬	psxk
橋	fell
涠	inav
粢	sepm
鹇	pfya
碹	doff
掃	axym
肭	wkte
獻	mfls
晊	jhkr
繃	bjww
簽	qrlk
慉	yovj
螣	wugk
璿	gmym
劂	suxm
篂	qjwg
眵	mrrk
銳	wtlq
嘅	lxvq
珧	gqss
吲	lvns
咁	lssi
锼	trnb
靿	gvxk
躧	nfki
苈	ssxk
翹	hhhx
蟪	kgyi
脈	wery
籃	qsqm
賺	muxt
坭	hbri
骕	xxtt
嶝	jbfu
钌	tvlj
嬸	coqj
項	fdmb
縡	boox
撥	abvq
锾	tehb
緜	emqb
饹	relv
簾	quut
斬	gejc
脞	wtth
厍	shch
賭	mhjr
鄹	abec
瓞	qqgu
碲	doum
編	binc
畤	jhac
茳	sifo
嵝	jpcn
躐	nvnb
鄜	icjl
諒	uoma
陧	cjht
鎖	wmmb
鹴	dfmy
镈	tfac
儘	exfm
鸸	syar
牻	wdto
輝	mhyg
縱	brtn
製	wkmr
訓	uqca
綁	bdcj
砹	dswl
铽	tgyi
跐	nnri
甦	fjww
熲	rudm
館	yobb
砘	daxg
阼	cqmo
燉	uove
踡	nugv
螗	kuxl
芴	swto
捨	athl
沷	isbo
飲	yeis
盩	hudm
茲	svvo
潄	ifle
迺	dpdx
埯	hgkd
碦	doel
塽	hgww
摅	amyi
廑	ugsi
堳	hbmf
澤	imhd
丶	odd
貨	ermb
姤	cefl
嫏	coxc
歛	reil
叢	kudb
酴	gtff
襬	pmvr
彎	ubbv
賤	mggg
鬿	weju
嬌	cell
琯	gobb
誦	ubtn
苄	somo
惱	yvrw
崒	jotd
憞	yove
舾	qdxo
扢	aqvi
鞗	eneg
掯	anwy
暈	jygc
舄	rwuo
硇	drwl
堍	hylo
燘	ukpw
姪	chkn
舊	swrj
醵	gmds
湯	ijft
艚	qsjj
爐	umjm
夼	gqcd
紖	bvns
浥	ilcb
筅	qwqr
榖	hffv
駛	dlwl
晧	jwlv
鼗	qssb
缋	vlkk
筯	qmxk
兗	otlq
懶	yflm
腘	wngo
皺	wxwv
奓	grrk
虧	mwfs
胨	wama
俛	eylq
拤	akmo
臟	wsgs
矻	dqvi
鍵	wxax
饸	ryes
迕	qdpd
烏	yww
蔘	svvt
砜	dqwl
淠	ijaj
違	cpdi
祄	htti
鮻	tvte
衪	pcyy
擠	aous
圊	nhwy
拃	aqmo
鲚	qpti
儍	ewxe
剉	tthm
钸	tsmv
喪	dllg
禍	hnas
阘	pjxx
勞	uuyx
蒨	sehw
鹓	orvy
哜	lpti
倉	toxl
貎	yrqr
菪	sodh
兊	tvqr
棲	fdxc
甕	ovqa
兲	gtin
輛	gfmr
杮	ffmv
撚	awsu
釿	wejj
朊	wfhw
橥	rhjf
蠊	kuut
盧	mjmn
暸	jgum
喛	lehb
惓	yugv
腈	whwy
埼	hgal
彌	vftw
骎	xxyb
扠	abod
箦	qhkb
筘	qalv
谿	evgl
躔	nukh
滗	iqrm
奌	mlgd
丷	uee
斲	gbje
凍	sfjr
鐾	blow
飾	yqmv
豾	ydfi
罣	mhht
暐	jcir
浬	ikks
蕺	slag
辶	pdd
亊	auxl
詛	umia
琎	gstp
駕	xldm
圏	nugb
仉	eqje
獞	rikk
縠	hfbs
琝	gjpw
犏	winc
濟	ious
絶	bycb
奧	rqpg
漥	iphh
溝	iskh
馘	utgf
鞞	gwdi
爚	uyln
毌	bdim
镧	tpfu
癋	pfjy
齉	tjar
垲	hjbj
扆	iory
獲	rswb
贊	wqwm
莶	stfi
綑	bnfv
髟	haaa
坶	hbmt
獵	rvnb
骦	xdfm
旂	oqej
绠	vfjw
瀟	isxf
糇	pebq
鋒	wedn
姎	ckgd
頸	fvfm
瘥	pufo
徑	rfvf
觽	ytjk
巻	ugbj
籓	qiqj
飐	qwml
罈	wdjd
钫	togj
坌	tbht
暼	umtj
堉	hovw
暢	kjft
滘	iytl
欻	uuei
梱	fnfv
臺	hlyh
潛	igqj
廻	nlxn
佢	egbu
礓	dfjf
蹯	nqpj
洩	ikqp
忄	yiii
玧	gvqr
監	sqmn
褟	pjxx
侶	elrn
頹	rqdm
挼	aecn
踼	njft
嫰	cfle
縫	bedp
羰	ujsu
蹽	ngum
趐	dxxi
裵	olry
罠	mcai
轘	gmfr
岽	jama
潤	ikgn
臘	wvnb
昻	jfxj
揞	aijr
辭	ebko
铋	tyqp
鸲	wlya
肀	xlll
閟	kyqp
缷	wxjo
厾	vhvv
閤	kyen
奪	gwac
両	fkjs
悅	ytlq
璛	gxtf
簷	qysu
倿	eicn
衄	qmbc
鼯	rbfl
齋	ounh
勳	wnxk
垞	hoqa
厔	shkh
藝	shtv
槨	fovc
陞	cqsh
啣	lqfx
縳	bgac
淓	isog
禥	hdht
梶	fbrm
昐	jtbd
恥	ayir
傺	ewhs
廂	ufmf
匊	wpmy
潰	ilkm
蚃	vqkc
胬	cbkt
澉	ivae
垟	hugt
繫	gxqb
剠	ommd
肼	wsti
塙	holt
酞	ggod
濤	ihva
廙	ujst
飺	nrys
桖	fqmn
锫	tilv
聰	arey
咶	lrev
誌	uhyi
鑄	whva
鹋	sjya
炧	uqcy
窀	paxg
枨	fthv
鹛	bmya
闖	kdmn
鹯	only
葰	seve
躹	wwpm
櫆	fwsd
圝	nubb
棁	fulq
窮	pwvg
螞	kdmc
珵	glgn
楶	self
赆	kbos
榍	fbmw
葢	sgom
葙	sfmf
讠	oaa
粿	pjfv
璆	gxxt
瓚	gwqm
捃	axql
窆	pqpe
鍾	wwkk
轒	gdsm
罨	mgkd
礌	ddjt
欗	fsku
鲃	qcby
鎯	woxc
燜	ukyi
鷹	uewr
蕹	sovw
桊	ugfv
騩	dwum
砮	cbdh
晩	jyjq
鎧	wjfu
俬	ervv
誡	ugsj
劒	rbod
樫	fsbh
療	pgum
蟭	kwuo
賴	flym
訊	uvdi
蒴	suxw
蟜	kell
欄	fkfu
恝	dbyi
轪	hgdc
鲻	qvjt
锿	tory
餜	yjfv
锬	tuuo
跞	ntma
媭	tdkc
倫	etfn
棆	ftfn
濆	idsm
睒	muuo
蜾	kjfv
銙	wgfs
蟟	kgum
篠	qenf
酤	gdgo
恓	ydxi
蒟	siwl
罰	mumd
渰	iysj
牴	wtao
闊	kire
厐	sdqp
丬	ueee
蠻	ubbk
眢	rvmf
巯	bfoq
钷	tglv
懸	mmqy
祏	hdhs
皘	ehwy
璱	gggq
绗	vrah
鷫	xtxr
謹	ugsi
罽	msum
懞	ysyd
訸	urha
熇	uolo
閑	kfvn
锪	twty
鉵	wkcj
饳	rxxg
獅	ryfm
貫	bdmb
糢	psjg
浰	irmd
勵	sskx
傘	tttd
韁	gfjf
缊	vjmn
驵	xmim
懗	yhtt
偓	ebhk
噀	lcct
阯	cnij
掭	afgo
憝	ovey
蛸	kmwy
滍	ixfk
歩	nmqp
鹍	jrry
冱	sfbm
覚	iymx
廟	udjw
稙	rdmi
虓	ymuf
糼	bxks
掹	avmn
芣	sduj
詳	uuga
瀬	iflm
齧	dbmc
柊	fesi
糧	pjfk
蔵	sdsc
礙	drqn
鳸	iroe
崚	jhte
聳	rtta
羧	uvte
庳	uwdi
馉	rmgs
飢	yqjs
眍	mgwl
註	uogn
钽	tjfi
铞	tlmv
瑆	gjwg
杻	fbcv
萆	swdi
瘅	pujd
衁	uqmn
鄤	jmbc
蔭	sctv
実	ogub
撿	arlo
倅	eotd
讇	ukyr
渾	iygc
刬	fgmd
阝	cjj
爇	shtu
罝	mmiw
锖	thwy
阽	cmlv
捥	aorv
鲒	qhlv
嘠	ldwg
嶒	jujj
搋	aemu
祹	hwwo
趯	dxxw
甓	bloa
眽	mery
渄	ilis
憟	ydpm
歺	mrko
姖	cgbu
瘭	pdhs
緻	bheh
縴	bovw
繻	bdsr
鹱	yswb
璮	gonf
綿	bemv
帱	mdac
瑒	gjft
棨	iefv
貪	tovm
蓥	sywj
噏	lyxx
纍	jjjb
墳	hdsm
汭	ikte
蕅	siky
芼	srmj
挶	abvl
腄	wesj
醜	gwuo
膩	wgsm
蚇	kbod
垤	hhkt
櫃	fglm
脅	xxxw
峇	jyes
鎙	wuxw
晅	jfjf
劙	bdkm
蝻	kdkd
衎	rhah
汙	ifau
荬	svsg
眊	mrmf
兌	tlqr
寯	owkf
勸	sllx
箨	qaba
扥	aqai
蠅	kjmc
癲	pdmm
嚕	ltjr
洑	iesq
泐	icxk
祔	heac
尅	dqac
悺	yobb
瘵	pwhs
賜	mjwt
峯	jedn
矦	ysqi
魯	tjry
浐	iiqp
運	ygpd
靬	ghge
罍	jjjw
倞	eoma
揹	aurw
迮	qmpd
冊	ncc
苧	soan
胩	wkmo
挾	agtt
禘	houm
曵	kqod
臢	wwqm
訏	ufau
妶	covo
垯	hgpd
鹖	jwty
钔	tpnj
絪	bngd
蓰	srnn
偲	ejyi
逬	qhqp
檢	frlv
騊	dwwo
痺	pwdi
晣	jaej
訶	ualv
谫	ouwb
窺	pgmx
朅	hvjx
鎮	wdmt
騷	dbok
瞝	mpxv
廍	uilc
嬰	mmcn
嬝	cror
齡	mtob
卨	mnao
跼	nbvl
暪	jsfr
溚	isye
瑪	gdmn
瑩	uuyo
衒	rova
炤	ublv
諡	utsm
耖	dtmq
峠	jkak
嚜	lnht
潅	iqfw
踺	nxax
嗚	lywv
窩	pnax
驅	dgll
飽	ywck
椠	hefv
雸	dssi
羮	uufg
賀	xlmb
誧	ufua
夂	ehh
鵝	qagr
唊	lgtt
簃	qrrr
穫	rswb
犮	sbod
碃	dhwy
鶉	ovro
嗢	ljmn
濺	imgg
纟	vss
鳼	prow
凥	bqjh
詢	uwjr
亸	ovud
譜	uukj
刧	hvbd
洐	irah
宀	obb
褧	auor
豎	sbfu
嫕	cgqy
殼	hfqj
脣	swyn
脽	wwiy
朘	wvte
襜	pysu
璷	gfoe
挓	aoqa
廒	uhwe
訪	uoga
葎	srxa
絃	bovo
廇	utjt
嘍	lldc
竄	prbu
惔	yuuo
屻	jbod
耞	dtxl
鬘	hjmb
娒	cqbm
癢	pugv
駼	dtff
侘	eoqa
蓳	sgsi
泶	iykv
攤	asfw
攵	ehhh
霊	dfau
赪	httk
赇	kfko
吜	lbcv
錶	whry
閰	krjn
涁	ifto
藫	sidj
榀	flll
氙	qjsq
渏	igal
氪	qdqr
軒	ghgc
睪	mhud
鹙	ruya
繩	bjms
衤	pyy
鰭	thrj
儲	euhj
珜	gugn
築	qfqf
齒	mcc
併	eusj
餬	ydwy
亹	orkm
聍	aoan
醣	guxl
誅	uwti
褕	ptfm
鴞	lsro
啲	lewo
癩	pflm
噽	hluf
辯	ouox
龜	qjmp
斝	llyd
遆	ouyp
頁	dmbh
鯹	tjwg
珦	grnn
彆	umtv
擓	agiw
踆	nvte
骙	xbfg
証	ufni
盷	mwsi
牿	wwlv
閱	ktlq
貞	mmbo
袥	pdhy
猹	rfjf
磡	ddxx
撘	aqye
溍	iauj
暱	jgsl
皽	onlv
減	idfl
蛁	kblv
燙	ijfu
丿	qpp
籙	qwxk
嚒	lpvo
渋	inss
篚	qgli
褍	pjsr
慶	ivye
裀	pngd
寛	osmx
螦	khbs
窊	pqux
埏	hqnx
癎	pkjr
納	bkte
珓	gotw
卆	ydif
锎	tpfs
舣	qowl
摟	aldc
評	uhue
爍	uevf
蹡	nxwa
鱗	tpra
镓	tods
攝	aaaa
糾	bxgs
褆	pjfn
頗	vdmb
鬱	fwft
焠	uotd
燋	uwuo
茻	xxxx
楓	frfv
憍	yell
馳	dcym
哴	lovn
玚	gvto
蝕	ykcs
栻	fgfo
礤	dswh
顓	jsdm
崈	ohjs
蹐	nssw
賦	mfgn
蹅	nfjf
筊	qotw
妸	calv
鼌	jflk
荊	sfsm
揝	aemj
謔	umxl
皕	djdj
黨	nnes
倶	emft
偊	eqkk
悾	ypfo
峊	yjsd
蓆	susm
覤	mmxu
祿	hbkv
鼷	rbeg
巈	jgwp
溼	ifvh
縛	bfac
枒	fhyv
裈	pyhc
痄	pqmo
鑨	wiwm
樋	fbtp
仫	eqvv
疍	vnjf
偡	edxi
漈	iwhs
砫	dogn
搵	antm
颭	rmlv
礟	ddww
唡	lfkt
抃	aomo
頠	ysvm
咇	lyqp
毘	jrri
攴	mbuo
訂	uana
繤	smgb
鏮	wuxk
鳢	qksu
饒	yhhh
掻	abkc
顠	dhdm
鐲	wmwk
馃	rjfv
週	whlp
鞃	gvvv
怳	ylqr
菓	sjfv
敚	ulqe
愑	ybtx
姞	chlv
濪	ihwc
頑	fhdm
鳙	quxw
扙	asod
榼	fhvm
趎	dwti
纁	bwne
艷	jddc
朏	wxxg
矝	cqtb
燻	uwne
螬	ksjj
巔	jdmm
杙	fgyv
焮	ueei
競	ilqq
羵	udsm
洚	ieao
頻	nmdm
藚	shmm
尪	dgno
頰	gttm
螵	kdhs
斅	rwwb
鈔	wmqp
硁	dbfo
麀	iril
迍	axpd
闢	kblo
鬽	wtou
洸	imhw
蓕	sfhh
菻	sffv
億	eijy
愝	ygjc
艸	xxgg
铑	thri
鍋	wnaj
镮	tmfr
鸊	blor
瀍	iukh
濊	indm
畯	jvte
菴	sgkd
償	enmb
嶽	jrus
稅	rtlq
眞	rmxt
嵙	jrsd
葜	sdbg
蝀	kfjr
聼	vady
綻	bofn
諷	urfa
麹	hewp
櫈	fbfq
儼	elle
磌	ddmt
撖	avae
拠	aeqj
懮	ydwe
壇	honf
耩	dtsh
帨	mulq
噓	lmxf
镦	tove
犺	roqj
瞵	mpra
蒳	sbkt
膄	wrnb
撢	adjd
钇	tvij
爊	uiuo
塗	itfh
匄	wuwy
鷉	emro
蔔	swfj
狹	rgtt
奷	cwkn
囷	nrhw
籤	qttf
飼	yvfl
矞	cqkl
澭	iovw
購	mskh
嘖	lhmb
璾	gous
芧	scuj
贳	hkbi
瞜	mldc
誕	uqnx
雛	wxww
璪	gllf
杇	ffsk
誇	ugfs
凖	swdi
鏈	wgpd
蹱	nikk
镎	tytu
澀	ibon
媜	cmmb
竢	ivqi
匯	giwi
闔	khvm
偵	emmb
挷	adcj
鉷	wsti
鞥	gysj
钐	ttoj
鸺	efya
歘	uuue
呂	lrnv
楗	fxax
娖	cnvn
廴	xnn
筭	qgsj
媧	cnan
魟	tfoy
曬	jfki
鋼	wkuj
捊	aevk
熌	ukte
鈇	wguj
汎	iqod
荳	sflu
唗	ldkv
圧	shth
輔	gfuc
轎	gell
朣	wikk
潑	ibvq
漼	ijwi
盦	tovm
禝	hjte
涴	iorv
壄	fcqh
橝	fdjd
鱽	qbdy
擬	arqn
畬	tffj
審	oqpj
貝	mbb
芵	sbte
翾	mflx
禖	hssf
蔣	sxwa
竊	pqpv
腸	wjft
筍	qwjr
濄	inpd
誐	uqag
醰	gdjd
絡	belv
謙	uuxt
郵	escj
瘖	pijr
胠	whvv
镋	tnqr
挐	cltu
阨	csvi
骣	xbvv
邁	skpd
驕	dell
袞	otlr
吿	wlvn
閣	kelv
蟸	dkkc
囍	hlul
曪	jmbw
偽	eoww
晼	jorv
甃	ruaw
侷	ebvl
囓	ldbm
灜	iumb
僎	ecct
曚	jsyd
醭	gkug
疊	jjjm
砢	dalv
嚿	lswr
萳	sdkd
辀	hqoc
鄘	uxwc
軌	gyfc
碨	djgf
昞	jfkt
泙	ihue
擡	ahlh
癨	pdwi
賊	mgso
哋	lhcy
彙	byjf
擱	akel
镃	tuvv
倻	eacj
宆	ovgb
儛	eqsa
裯	pwhl
掞	auuo
搗	arjs
泂	iklv
敧	galb
込	rpdu
鹎	wdya
雝	vlcw
犋	wmti
棟	ffjr
蔹	stfe
菼	suuo
耑	jsrs
膣	wphk
嶋	jros
蘇	strh
筳	qexn
眮	mkfl
摎	axxt
腽	wjmn
瀼	iolr
囯	ngnw
絔	bdjr
鹢	utmy
耠	dtye
顛	dmtm
舖	thlf
矌	must
篛	qvss
蛦	kgvg
镴	tvnb
揙	ainc
滯	isfm
戦	ijdg
劐	swbm
鹔	xtty
鳓	qgxk
濩	iswb
泆	iqgu
窾	phhe
栒	fwjr
搯	aerj
槻	fgmx
嚆	lsol
狜	rdgq
鴦	kgro
麕	inrh
巘	jmfs
勅	flxk
瞍	mrnb
洶	iwwx
鸴	iyya
譽	rsku
髈	mouo
鑰	wyln
譚	udjd
闋	kbfg
萜	smml
脥	wgtt
穌	trhy
饀	yerj
隠	cexy
経	bbht
婞	chud
尓	qmak
蔥	srey
績	bhmb
吚	lxqp
怮	yvxk
鞶	qqge
餗	yflv
攽	tbeh
喤	legn
滄	itol
誔	uexn
軏	ghwc
眘	gumf
噇	likk
朧	wiwm
朒	wktt
艙	qtol
噷	lije
澴	imfr
靇	diwm
賢	sbmb
鄴	kutc
銷	wmwy
邉	tplp
駡	lldm
浿	imbs
抷	adfi
銅	wkfl
鐚	wfjy
憯	ygqj
訣	ubte
斃	umtr
撴	aove
轅	ghlr
嗛	luxt
裩	pjrr
柈	fuao
橿	ffjf
杄	fwkv
靨	sjwg
钆	txij
曠	just
慍	yntm
朓	wqss
脎	wwfv
鐏	wuga
舭	qrri
蒐	swuj
魋	wwiu
饦	rqai
厖	sdto
稂	rovn
釦	wlvj
飊	uuur
抜	asbu
鈚	wrri
躭	wyqr
遯	wdpd
侫	eucn
蒻	svss
踧	nkmb
渦	inas
馎	rfac
纖	bttf
盻	mtsk
噐	llfl
葔	sebq
窪	pihh
漷	iovc
謊	usuq
鹹	kdfl
丗	sfij
灘	isfw
漲	ivha
覷	mkmx
宧	oscb
煵	udkd
鰣	tjha
麥	dehl
淂	ijfa
偁	eekh
瘕	pbsb
睖	mhte
陜	cgtt
刄	bodd
啞	lfja
餂	yres
羃	msjm
鄭	uggc
摰	htht
債	ehmb
渟	ioan
楛	fsdg
徴	rgni
玆	ovov
効	otwx
粞	pdxm
棬	fugv
矓	miwm
韻	ijlm
艱	sflv
剬	jsmd
瀞	ihwv
潝	iyxx
僇	exxt
滃	itvx
螢	uuyk
嗶	ljsa
驟	dabs
壽	hvfa
掫	aabu
侼	edyv
皏	eusj
咉	lkgd
駭	doim
縢	wugb
暎	jskg
屭	bmmm
奡	dmgt
懇	yvyi
靪	gane
綱	bkuj
嬿	csfu
胐	wxxg
廞	uwei
糞	pjst
耵	aanr
祙	hhes
薆	seye
膪	woul
殽	wswq
扺	atai
禿	rqrh
稌	rtff
雚	sllw
隢	chhh
舑	rkht
癱	psfw
晸	jfne
緼	bjmn
鬹	gmfn
娭	cvqi
樉	fgww
豈	jflu
噠	lhup
巒	ubbj
镅	tbmf
膦	wpra
沘	irri
逷	jwtp
燦	umrp
憊	esqy
洢	iexq
巜	vccc
躘	niwm
獰	roya
慒	ysjj
蠙	kofm
魘	sjww
鸧	tvya
篤	qdmk
虇	svsw
邅	onlp
袑	pblv
遫	flep
暤	jegd
鮀	tori
侁	ewqr
坉	haxg
昫	jwlv
嚨	liwm
铟	tngd
碻	dolh
疰	pogn
頀	ijsb
酺	gfuo
吳	lxgd
黦	norv
漁	itys
疪	prri
嗆	ltol
醃	ggkd
迶	swpd
寵	oiwm
珌	gyqp
瑑	gbds
鮗	tesi
煴	ujmn
栆	dlts
縣	mmqb
缏	vefw
摗	afle
砵	dffi
騒	dbkc
筦	qofh
祅	heos
囮	neri
蔀	silc
軿	gusj
攔	akfu
嬤	cpvo
擭	aswb
柷	flqr
咾	lhri
柸	fdfi
襯	pifm
宭	oxql
虀	souf
鈕	wbcj
醑	gvnw
癃	pcew
贌	mkug
篴	qdpd
擴	aust
铚	thkj
呴	lwlv
儵	enen
铌	tbri
昩	jhor
嘩	lshs
湳	idkd
臞	wmmw
鬒	hdmt
嚧	lmjm
鏢	wdhs
檓	frfq
寃	oylo
暕	jfnu
鑯	wttf
餅	yusj
蜋	kovn
鹵	kll
鬺	flkt
棌	fefv
靑	hkks
鎔	wptl
藟	sjjj
搢	aauj
涶	iesj
毣	xxrm
蠟	kvnb
豝	dcbs
皀	erib
璹	ghva
敊	kmmb
瓏	giwm
兛	dqwk
狽	rmbq
踘	nwpm
啓	ielv
筸	qjhg
剝	bkmd
嘨	lxpt
剷	iqwm
韮	slfi
磝	dhwe
倷	eghs
遜	vqbp
硚	deti
唌	lqnx
繐	bgyi
漤	iffc
屆	bhxg
杬	ffhw
鈡	wlns
恗	ygfs
耰	dtde
褵	ppxv
趙	dmwy
憵	bloy
槤	fgpd
挦	axac
瓃	gjjj
竜	ikdd
鞎	gvne
鰡	ttjt
変	pehi
葊	sysj
瑤	gwwo
鏰	wjww
瓫	tbaw
辮	obox
耢	dtsx
釀	golr
僱	eiwi
倕	eesj
嫵	cqsu
抯	amio
扜	afau
鬴	flkf
喯	lgds
咷	lqss
屜	brhi
絨	bgso
豤	dvns
睄	mmwy
揳	adbg
莾	sgds
涭	ieyb
觱	dflt
觝	ytto
滛	iewo
蹺	nhhh
簑	qofr
晛	jmxr
験	dyte
脤	wsny
箙	qwxb
愖	ydxi
慽	ydkm
宊	osqb
礑	dnjt
儈	etfj
勻	wsiy
岕	jtti
鰉	tegn
妧	cfhw
畷	jbbb
栢	fdjr
嵎	jkys
绖	vhks
籥	qyln
焄	xqlu
汸	iogs
緞	befq
坵	hefi
擩	adsr
籟	qflm
劄	qymd
曽	ujjr
栴	fqwo
鴳	ocro
眫	muao
頷	tovm
渧	ioum
蔴	spaj
犖	uuyw
臍	wous
碥	dinc
髃	mkyg
襛	pkss
簠	qfmn
鰲	hwet
欵	rqei
揌	ajyi
狢	relv
玼	gnri
呉	lxft
莖	sfvf
霙	dskg
殢	frsm
錞	wovk
鲙	qtsv
衆	qmes
謠	uwwo
鰏	tflj
簮	qggj
镩	tpln
矈	mepo
旿	jqdi
筩	qbtn
睮	mtfm
鴸	wtro
麑	irqr
鬵	gqgn
鉄	wqgu
賠	milv
搆	askh
茓	spxj
蓣	scdk
挰	algn
蘿	smbw
羶	uonf
駁	dwwl
燼	uxfm
葦	scij
乢	jxis
藠	seee
纋	bdwe
鞰	gjmn
鉤	wwlv
敘	tffe
憇	rssy
鞆	gfkt
氺	kvvv
嗮	ljdx
棐	lfvi
蝽	kgjr
麯	deks
錘	wesj
蜺	krqr
肈	igxa
愜	yggt
猙	rexv
癕	povw
鈌	wbte
磞	djww
賨	ohmb
巵	efcb
袗	ptto
皁	edib
喓	ldcn
耥	dtns
濁	imwk
铼	tfpm
仂	exke
鄰	prac
捁	awlv
瑋	gcin
凃	stff
旳	jwod
獃	jfls
渼	iugd
舲	qtob
嶺	jtom
咑	laan
譟	ullf
苽	squj
澥	iytw
惙	ybbb
饋	ylkm
熾	uijg
鸁	urow
豗	hdsw
怊	yblv
嵖	jfjf
蝂	kteb
弔	vnsg
縷	bldc
籠	qiwm
枴	flbd
儯	eugd
扐	axko
礜	rskd
唝	lfkb
镄	tvtk
濙	iuuu
稟	onlr
鄚	sjgc
譯	umhd
踖	nsjr
笹	qhik
黴	rfne
豊	ksfu
屝	blih
誙	ufvf
釘	wanj
碩	ddmb
莙	sxql
崄	jtfi
菝	saso
斂	rehl
悢	yovn
骻	mgfs
榢	fods
吪	leri
嗗	lmgv
庼	urdk
泹	ijfi
晈	jotw
牣	wbod
尃	facu
鲌	qeby
焅	uwlv
瑳	gufo
劖	ylrm
犧	wurg
癮	pcey
寑	oexb
飆	sssr
頔	kdmb
蟁	cakk
掤	awwy
侓	exao
徧	rinc
楢	fugo
淵	itxf
飔	qwjy
堌	hndg
匤	ggod
淪	itfn
渻	imqm
唅	ltol
暋	caej
脲	wbkv
崿	jlls
苳	sesi
拺	afkf
诐	ovpa
缐	vekv
儸	embw
訕	ujsa
紈	byod
郱	uscj
拑	assi
姦	cccn
鰗	tdwy
貧	tbmb
磚	dgac
盝	xkmn
飗	qwtj
攢	awqm
硿	dpfo
鲐	qvlv
慆	yerj
袵	peen
蠧	hydk
詑	uori
箠	qesj
鰧	wugt
踨	nttn
栣	feen
蚿	kovo
鞷	flkg
蘊	sbnm
産	iqwg
灕	ipxw
牁	xalv
蠶	gqgk
霅	duay
嵐	jrfs
憚	ylld
頌	tvdm
贈	mujj
窋	pxxg
瓛	gmfs
酏	gcyo
鑾	ubbw
缲	vllf
滪	icdk
洊	isnv
頒	tbdm
澒	ifdm
輟	gbbb
铏	tfsm
鵹	rwqr
挕	aaro
嬻	chmm
癀	pskt
搫	qqtu
喣	lwlu
鴉	hroy
彥	psto
譎	ucql
綵	befv
戸	ieee
憗	deyi
煕	scuo
挜	aaue
嚗	ljsk
赨	httk
袿	phht
柮	fxxg
樸	fkug
鱓	tlld
婗	crqr
済	ipts
禪	hlld
铇	twck
勍	omxk
槓	ffmb
鎲	wnqr
鸑	rusr
凘	sdej
娀	cgso
褯	pusm
齆	tjac
粧	puht
痀	pwlv
亖	ssii
礎	dffn
鳘	qbeq
秗	reoh
肐	wqvi
稧	rdbg
讙	uslw
陿	cggt
戤	vbmg
壂	bsth
盃	dmnu
摥	aqjt
煶	ujfn
恘	yefv
臒	wswb
啅	lmjd
釁	rkfb
吥	lduv
惛	ytaj
嬬	cdsr
楩	fefw
蹠	nusu
睸	mbmf
澆	ihhh
簉	qwlp
羈	mgdm
榦	djtf
脧	wvte
涏	iexn
濫	isqm
氈	onlr
樁	fgrj
綴	bbbb
墦	hqpj
脹	whay
漿	xwak
逌	mnbp
妬	cdhn
穢	rndm
輗	grqr
竅	peoe
廕	uctv
鈎	wwvv
棪	fuuo
陏	cswy
冂	kff
枙	fsvi
蜼	kwic
慥	ywlp
痾	pcal
墊	hudh
媟	chfv
禋	hdht
嶬	juqg
醄	gwwo
慇	exvy
鳀	qjfn
鼢	rbtb
釣	wwod
巂	jwkl
牋	tggg
皦	eeoe
邭	wlcj
嚚	llsl
翯	xxol
睍	mmxf
穉	rbkw
熛	udhs
宬	odvi
懽	yslw
偪	eflj
兪	rfwv
傜	eewo
矰	qujj
蠋	kmwk
韓	djci
疢	puob
魖	wmkg
荖	shri
膠	wxxt
屇	bjth
毦	armr
勷	olsx
獏	rsjg
玽	gwlv
醁	gxkv
酙	gsdi
詐	uqmo
漧	idjv
碞	llld
迒	oqpd
鍛	wefq
骹	motw
脰	wflu
梟	rfvo
瞫	mdjd
絙	bfjf
眝	moan
茇	ssbo
硰	imqd
繄	gqqb
磳	dujj
囑	lbkk
鐄	wskt
滶	ihwe
鐻	wmds
轓	gqpj
麄	tbil
磈	dwuh
軃	wlld
锧	tedk
緲	bmmq
稊	ruvq
憀	yxxt
磉	dbbf
兓	gqgq
燐	upra
祘	hhss
幋	qqmv
醨	gpxv
増	hujj
蝦	kbsb
挌	aelv
巇	jmfg
臲	tfyv
塆	hpvg
発	bsqr
綢	bwhl
碔	dfgn
礞	dsyd
袐	pyqp
髥	hksi
飋	rggq
趨	dwxx
犂	rwqw
雰	dtbd
覩	hjmx
録	wxkv
姵	cqfm
酂	wqwc
虩	mjmm
粋	pydi
窎	pyax
膆	whbs
闍	khjr
冦	yfhb
欬	oeii
罥	mlwy
誱	ufxn
曮	jlle
腫	wwkk
嫃	cdmt
壺	hyja
驀	sjgd
沍	ifbm
碏	dsjr
贗	serm
煆	ubsb
侽	ejxk
唚	lxyb
缞	vofr
慬	ygsi
璫	gnjt
煹	uskh
綉	brvj
炟	ujfi
悵	yhai
滳	ioul
穂	rfky
恇	yggn
橕	fnhy
銘	wrlv
嗏	lstf
褾	pdhs
覙	ymmx
騃	dvqi
蒒	syfm
蹧	nsjj
蔾	srwf
牮	egwn
袠	oqgr
蘘	solr
緤	bhfv
漻	ixxt
壖	hdsr
崗	jkuj
篨	qctf
絞	botw
菿	shmd
帩	mmwy
帢	myev
筴	qgtt
鯛	twhl
闬	phgn
瑮	gdfv
齷	mbhk
椀	forv
擵	aptu
詨	uotw
醬	xwag
欶	flei
淊	iyrj
緝	blar
嵁	jdxi
駹	ddto
飸	lsys
訳	ubod
姫	cscn
儭	eifm
佽	esei
瑣	gmmb
烓	uhht
釵	wbod
魀	wtti
鵚	rqro
齪	mnvc
憙	hluy
鞧	gugo
溁	isyf
澽	imds
趫	dell
蹍	nbsg
誸	uvov
盞	ggmn
唶	lsjr
愽	yfac
僕	ekug
齬	mfcl
嫞	cuxw
鉏	wmij
噉	lvae
毷	ksmr
様	fukv
淛	iwkm
呠	lffi
衕	rkfa
蟳	kxfa
菥	sfej
猨	rehb
攙	aylo
鷬	sktr
兎	qlqo
覼	ftmm
糥	pssr
绤	vttl
鋋	wqnx
骃	xngd
喴	ldfc
睲	mjwg
嶓	jqpj
薿	srqn
琱	gwhl
擿	aoup
刪	nmdc
狑	rtob
焇	umwy
縈	uuyb
蕭	sxtf
歯	npxg
鵬	wwro
絆	buao
錐	wwij
睆	mofh
郈	eflc
秅	rqai
贖	mhmm
葅	sttm
哱	ldyv
滈	iols
镨	tukj
嘔	lgll
轍	gove
攪	arwm
訑	ucya
堷	hijr
癴	pubt
珫	govq
緬	bgis
耔	dtvk
閦	kttt
哃	lkfl
徶	rume
廾	sjjj
厠	smmd
秏	rrmh
諧	urre
熣	ujwi
曆	srrj
颼	rrnb
哖	lqao
膙	wvlk
焟	usjr
姱	cgfs
繆	bxxt
欉	fkub
繚	bgum
蓏	sqqu
瓌	gomr
塹	geht
踚	ntfn
檡	fmhd
剚	alxm
鐺	wnjt
矔	mslw
衠	rdma
乗	rsjh
矊	mbem
嫀	cgrh
娛	clxg
酕	grmo
楏	fghh
脒	wpmy
泝	ieod
僄	edhs
籬	qpxw
鄫	ujuc
澨	iqft
兯	uxje
諔	ukmb
鉆	wmlv
夋	vteh
婙	cyxv
糬	pmhj
蕓	sdsv
蟢	khll
羒	utbd
湝	irre
勈	btxk
帲	mqhh
繽	bofm
冓	skht
氳	qntm
琩	gjjr
臓	wsds
秖	rtai
歠	bbbe
峽	jgtt
圞	nubf
矋	mssk
粄	pebu
鹮	mfly
斁	mhue
浟	iene
牐	twrj
錧	wobb
簰	qtwd
勀	dqxk
阛	pmfr
処	eqjh
嘮	luux
臑	wdsr
卲	blxj
鷿	blor
吰	lsvv
巗	jlle
鲗	qkmd
鞡	gaid
篋	qggt
筞	qofv
僊	edgc
蝲	kflm
靰	ghwe
螲	kphk
瘝	pmkv
釬	whgj
拝	afdn
煼	uwxx
烕	dfuo
迵	kflp
鹐	yrya
璉	ggpd
苙	sidj
銊	wdfi
貒	yjsr
讞	umfs
貙	ygll
踶	njfn
窯	puuo
髏	mldc
跓	nogn
潏	icql
痠	pvte
廚	uhla
涷	ifjr
鯾	tefw
颯	irfd
誼	uomi
摯	hudt
锽	tegn
姶	cyen
尫	hgnw
潟	irwu
泩	iwgs
髴	hvti
牚	nhys
枲	vlfv
嬢	cotr
譪	usjx
抅	awvv
爧	udlt
軦	glqr
洴	iusj
綯	bwwo
攅	aggm
寖	oixb
鈍	waxg
諕	umua
気	qwlq
揵	axax
曇	jdsv
飂	rxxt
廬	umjm
妝	xcnp
褅	poum
裇	pqmn
鯊	imqt
欽	weij
桲	fdyv
涰	ibbb
鴨	kroj
镵	tylo
鄗	ocjl
鍠	wegn
俢	eeto
禂	hwhl
峵	josv
鋙	wfcl
碝	dsgd
杦	fyod
鵩	wxbr
饾	rflu
蟦	kdsm
骴	mnri
鏟	wiqw
喹	lghh
迻	rrpd
翣	xxic
闉	kdht
蓚	sent
躩	nmmb
騨	dijd
梾	ffpm
厪	sgsi
嵂	jrxa
秬	rgbu
鼽	tjay
餔	yfus
恞	ygvg
瞹	meye
曖	jeye
啗	lyrj
昬	cajr
邲	yqcj
辢	flox
貢	fmbo
榅	fjmn
襩	phmm
筻	qfjw
熕	ufmb
嗱	lytu
娵	cabu
宍	ooti
鳷	dbro
龒	iwmh
斶	emwk
傌	edme
幒	mrey
癚	pysu
髢	hcya
覊	dgdm
榾	fmgv
醖	gjmn
礧	djjj
淺	iggg
撝	aeww
攲	galb
琭	gxkv
剕	lmdi
缽	wffi
儾	edlr
綣	bugv
喫	ldbg
詌	ussi
盫	ygmn
繖	bswe
啑	lfxn
鲰	qabu
醌	gjrr
橸	fjjj
覓	emxk
鷟	oqqr
倂	eqhh
鐧	wkjr
銹	wrvj
蒑	sexq
噑	lesd
僥	ehhh
蝜	kymb
隄	cjfn
遷	dgcp
璄	gijq
刲	hhmd
駝	dori
裛	olcr
钖	tvto
恡	ywsv
鏗	wsbh
琙	gglf
熥	ubtp
俍	eovn
褭	odry
姍	cncn
蕰	sijm
櫜	dlyf
呪	llqr
蘪	sipm
鷃	jocr
赒	kwhl
頞	ocdm
哊	lswy
鞦	gruo
吙	luov
埈	hvte
菂	sewo
瓓	gkfu
颋	exdk
襈	pcct
劑	ounm
兠	eurq
髽	htth
騑	dlim
玃	rmmb
珹	gdvi
遈	jfnp
躪	nskw
暏	jhjr
駮	dotw
啈	lhud
荅	syej
枓	fsdi
綺	bgal
睌	mylq
曎	jmhd
袮	pqma
鉥	wfod
孋	cfki
駉	dklv
捒	aflv
軫	gtto
熖	uerj
覀	dxxx
镥	tqjr
弍	gsiy
穟	rudp
嬾	cflm
趷	nqvi
挵	agsj
訧	udoa
稃	revk
敠	bbbb
喭	liqt
鴻	ifro
楉	fssl
痃	povo
鼑	mmxt
俁	elxg
榑	ffac
薦	sisu
蠈	mgsk
鸂	ievr
齣	mwlv
輯	glar
彫	whlt
郪	dxcc
瑺	gnmv
豖	dods
裭	pmuy
噭	leoe
疒	pbb
冖	ymm
巊	jmmc
鶴	ywro
鞓	glgn
囖	lqmw
穎	rrdm
妰	cqmo
矚	mbkk
呺	llsk
鬅	hwwy
眤	mbri
癶	buuu
芻	wxwx
媢	cksm
黱	wugn
枌	ftbd
軻	galv
翝	osvx
鮎	tmlv
撃	gqtu
灩	ijdm
罇	wuga
敍	tffb
蠸	kslw
絯	bois
醽	gdll
阬	coqj
馴	dqcm
毆	gllq
橧	fujj
鋿	wnsj
浭	ifjw
呟	lovo
屛	bqhh
穄	rwhs
嚔	ldyn
壼	hyfj
瘃	pdod
禚	huuo
縰	brnn
脁	wqss
諠	uoff
韡	cshs
晉	fvvj
鰃	tjgf
逕	fvfp
贅	hwem
麤	iiil
傞	eufo
靂	dsrn
黐	rtkv
脢	wqbm
孉	cslw
緌	brcn
揀	afnu
繪	btfj
彽	rtao
輾	gbsg
玨	ggnn
馂	rvte
讻	owxg
雔	wwii
癉	plld
颳	rref
弎	gfay
褀	pdjy
嘷	ltsd
冿	sxao
蒄	syfa
狓	rvpq
鐩	wudp
繡	bxtf
膫	wgum
硏	dhhg
聻	igea
綽	bmjd
唘	dblv
錅	rwqw
絢	bwjr
魼	thvv
鏽	wxtf
嗃	lolv
珖	gmhw
嘓	lngf
駃	dbte
媼	cntm
嫿	cxhf
椪	fukg
冨	yflj
顱	mjmm
簕	qgxk
摐	artn
珝	gxxi
渉	inmq
籄	qglm
爄	ussk
粫	psrm
摃	afmb
茖	selv
鄀	sslc
旵	jjsr
狉	rdfi
巚	jmfs
刓	fhmd
絰	bhks
撦	aghj
兏	ekqr
箇	qndg
眥	nrmf
眆	mogf
幰	mody
筜	qmxl
嵵	jjha
曀	jhyu
猋	sssq
嵕	jwxe
巃	jiwm
擼	atjr
闌	kfnu
鳆	qqje
県	mxma
傐	eole
続	bhyq
簖	qpxe
眐	mfni
藨	siuo
倣	eoeh
椯	fjsr
俆	etff
瘡	ptol
髣	hoga
歀	fhei
訫	uyia
碢	dnah
広	uvvu
偱	eedm
僣	eggj
煠	uhfv
璊	gsfr
摚	anht
捜	akbu
嚞	hlhl
龑	iwmg
譓	ugyi
潚	ixtf
捵	akst
幀	mmmb
袊	ptob
搰	amgo
幙	msjg
奍	ugti
淴	iwty
菫	sflh
讃	uggm
鼕	hlus
畝	ojyo
忳	yaxg
薬	sesf
掁	ahao
槱	fguo
蓇	smgj
抆	apwo
嵚	jtei
営	iyll
怰	yovo
焃	uhtt
値	edmx
斠	skhd
昡	jovo
莂	slxm
楻	fegn
搒	aouo
縺	bgpd
岍	jfsj
饤	rans
敻	ykte
澻	iudp
椏	ffja
蚆	kcbc
鄡	rfcj
勊	dqxk
迾	frmp
墻	hhtl
頬	gudm
桯	flgn
仏	evve
曒	jeoe
抝	avvi
坬	hqut
粃	prri
幵	hhgg
藴	sbjm
塨	hsto
兞	dqrm
蘆	smjm
敁	mlmb
鷄	evgr
蓺	shto
虡	mkti
憫	ykpw
卹	qmxj
餚	ywsw
煚	jgbu
艶	ksfc
蚮	kegy
騠	djfn
蝪	kjft
冡	yfds
壎	hwne
耱	dtpd
譁	ushs
巹	vkfb
漣	igpd
篜	qvku
稲	renj
檳	fofm
鳈	qekv
韄	gswb
燭	umwk
愄	yjgf
剟	bbbm
騂	doxm
僝	ebvv
鏘	wxwa
玊	godn
遝	mkpd
礐	rwwd
唃	lytn
鮹	tmwy
玁	rlle
膲	wwuo
孼	xyov
餿	yrnb
覧	sqmx
賬	mhab
兡	dqdj
觺	rqbt
繙	bqpj
噥	lkss
遡	uxwp
鄧	bflc
怤	eayi
矙	mkve
覠	xqlm
隕	clmb
眱	mgvg
鬖	hvvt
虜	mjxk
蛼	kgcc
冺	scai
牸	wovk
愊	yflj
埇	hbtn
胘	wovo
澱	ibsq
椸	foqc
踀	nnvv
蝭	kjfn
洿	igfs
伮	ecbu
卼	hysv
絁	bqcy
皥	etsd
腂	wjfv
癟	pttn
瓊	gyke
噯	leye
辧	obox
瞱	mshs
謢	uwbu
鑲	wolr
緑	bxkv
弾	vijd
藘	smjy
巑	jwqm
瞐	mmmf
邩	ucjo
雊	wlwi
晝	xhjf
畇	jwsi
関	kugd
矘	mnne
炵	uesi
綹	beml
挙	ittu
鷘	fler
狶	rwsm
悁	ylwy
矉	mofm
赗	kksm
忬	ycui
耭	dtvt
瀂	itjr
瑬	iovo
靄	dujx
昒	jwto
毼	jwtr
珇	gmin
耹	atov
灋	iisv
犽	rhyq
鄩	xflc
夐	ykte
揅	dfst
鴂	btro
擲	augc
垐	seht
祲	hxyb
獝	rcql
愒	yjwx
諂	uyrj
淸	ihkk
枻	fhiv
瀾	ikfu
甁	qhqa
搊	awxx
鴈	sero
慤	hqyi
瀝	isrn
眔	mkvw
寽	eack
詥	uyea
鞚	gpfo
抶	aqgu
瞶	mlkm
乄	vodi
瀉	ioru
咲	lugd
廸	kxno
叚	bsbb
囁	laaa
矴	danh
醿	gpbs
馱	dgdm
隸	fhxk
祫	hyes
弨	vblv
槖	hydf
櫬	fifm
麃	iuol
槺	fuxk
抈	awyo
薫	swku
菾	sfgo
踦	ngal
塭	hjmn
豋	wflu
蹎	ndmt
膸	wsfp
觹	ytwk
爠	ummw
晻	jgkd
癈	pbvq
崌	jbdg
歳	ndfm
僷	eshf
漦	hesk
獕	rjwi
歭	nhac
鏁	wvjf
輦	gggc
頟	eldm
殹	gqqh
浄	iyxv
穠	rkss
箒	qxym
殲	frtf
褉	pdbg
侲	esne
澪	idtb
搕	ahvm
巐	jojs
槡	fbbf
嚀	loya
吅	llvv
俇	ergn
対	pacw
腃	wugv
壡	myfh
抳	abri
蔍	silj
覥	kstm
璬	geoe
阢	chwj
霬	djst
跅	neod
翂	xxtb
墥	hikk
鴙	qroi
睩	mxkv
奤	ggid
壘	jjjh
烱	uktl
餽	ywus
畾	jjjt
熯	usfg
佖	eyqp
佪	enlv
矎	myke
紐	bbcs
懭	yust
衺	ohry
朼	friv
椓	fdod
躄	blon
鹽	sqkm
恾	ysuw
厎	stao
鮝	ugty
磥	djbs
繭	sknk
譴	ulkp
栿	fesq
攜	ajwl
顰	nmdd
墵	hdsv
栃	fefw
冃	ksif
綫	bggg
铷	tclv
筼	qlkb
廠	uneh
綜	bohs
覇	dgwy
牀	xfvp
猂	rjhg
鱉	umtt
絹	blwy
錦	wemv
鉶	wfsm
晬	jotd
髆	mfac
鬨	nsti
兝	dqtb
働	ewkx
塩	hqlm
刜	vtmd
諏	uabu
膔	wily
灬	uooo
貋	yjhg
撈	auux
婌	ckmb
镤	tkug
覜	qssm
頤	sdmb
崅	jytn
圂	ndsw
禨	hvvt
裊	rory
榺	wugf
莻	svlr
驎	dpra
柫	fvti
獦	rsjx
僁	eqpy
兙	dqdi
跴	ndxv
呫	lmlv
皐	essd
昄	jebu
楽	essf
礵	ddfm
躑	nugc
鋘	wlfg
褞	pjmn
嶈	jxwa
磗	dfac
簁	qrnn
盇	gomn
堐	hshh
屮	xggg
衵	pjry
襴	pkfu
蜅	kfuc
骫	myod
懺	yttf
菨	sicn
鷔	hwer
嶼	jrst
虯	kxgc
籌	qhva
憭	ygum
摳	agll
鈿	wjtj
闐	kdmt
肸	wtdi
岠	jgbu
査	fmiv
韨	avso
鷩	umtr
椫	fujd
伝	esvv
頃	rdmb
昚	gujr
遼	gujp
鰤	tyfm
嚮	vqor
覽	sqmm
柤	fmiv
啽	lysj
娚	cjxk
鍚	wjft
眏	mkgd
蝍	kxvx
昜	jfwt
詔	ublv
捘	avte
禆	hwdi
扅	irrk
磂	dtjt
鮰	tnlv
嚬	lnmm
狌	rwgq
葴	sdfl
鉅	wgbu
鷡	qsfr
铈	tomv
敭	jfwe
巣	ijfv
躡	naaa
冎	naaa
矕	ubbm
盄	vnmn
浡	idyv
襨	pkua
襆	pkug
揜	aysj
瞆	mlkk
鄃	tfwc
硑	dusj
凂	sylq
頽	rqdm
怹	ecyi
庛	unri
浹	igtt
邤	ecjj
籧	qmdp
讟	uhmu
躝	nkfu
鵑	lwro
喞	lerx
呧	ltao
璂	gdht
読	uhyq
唩	lrcn
睠	mugv
隩	crpg
傓	eixx
痡	pfub
饘	yonf
紳	bkes
鴥	rpxo
檿	sjwf
儽	ejjb
嵉	joan
熝	uilo
鐭	wrpg
褻	ohtr
胔	nrkt
澼	iblo
冮	sfoi
睞	mdlf
躙	nkwi
譏	uvvt
襥	pekg
孅	cttf
芛	sxqp
咗	lsfo
阺	ctao
籣	qkfu
覮	uuym
窰	pewo
濔	iftw
跙	nmiv
剮	nmda
餋	ugys
岞	jqmo
鉓	wqmv
惷	gjyi
韌	cbod
苖	skoj
琌	gjtv
湅	ifnu
踐	nggg
撾	anpd
鱲	tvnb
禃	hdmi
陝	cgrr
唽	lfej
掟	aofn
塿	hldc
禑	hkys
櫂	fxxw
澿	iffh
騕	ddcn
腪	wygc
稭	rrre
収	xbug
壃	hfjf
尐	moda
儅	enjt
螋	krnb
篶	qfnu
酅	jwkc
糰	pnga
涙	iigd
葧	sdyx
塥	hfln
懆	yllf
駿	dvte
晲	jrqr
襪	psmo
硍	dvnh
亙	fwfi
玈	ovqr
愳	mmyi
鴏	regy
総	btvy
巌	jise
摴	adfs
鋁	wllv
枼	hfvi
搾	apqm
謿	udjw
萣	sofn
晙	jvte
絛	eneb
礬	fwwd
駸	dxyb
晫	jmjd
奺	cyod
莋	seqm
郙	fcju
驃	ddhs
啛	ldxc
剺	hesb
疐	dyjn
灐	iuuw
扝	afsk
瑍	gykg
蜑	qnxk
渞	iutk
犛	hesw
泈	iesi
篘	qwxx
挒	afrm
埗	hnma
啴	lujd
弪	vbfo
抦	afkt
骲	mwck
驌	dxtf
謀	ussf
惻	ymmd
嵰	juxt
煋	ujwg
棓	filv
犠	wuqg
眗	mwlv
駥	dgso
楧	fskg
赕	kuuo
闒	kjxx
醩	gsjj
瘉	ptfm
鏠	wedp
屟	bhfv
楡	frfv
穜	rikk
竒	ilvi
舋	rkfm
辁	htgn
瀕	inmm
鱑	tskt
瑏	gphy
诪	odac
鹥	gqqy
馌	rhvm
矖	mfki
鞳	gsye
珋	gtmn
脦	wgyi
逤	imqp
蠣	kssk
鑿	kudw
苺	sbmj
袚	psbo
邔	bcjj
駟	dnqr
軼	gqgu
蟷	knjt
綀	bflv
馩	rjdm
鷲	omdr
禬	htfj
碐	dhte
鰜	tuxt
糒	psqt
閛	khue
欖	fsqm
茞	sscj
濱	iofm
鬑	huxt
紵	boan
璥	gswe
痳	psia
鬋	huwm
慭	fpsy
伈	eyie
哬	leal
奜	lgdi
攣	ubbt
僽	eruy
碪	ddxi
頩	usdm
縊	butm
狟	rfjf
抧	alti
犾	rsqq
廲	ufki
迖	spdq
湹	iskk
庮	ugou
硊	dysv
潠	icct
骭	mhgg
跔	nwlv
鵜	uvnr
聛	awdi
喎	lnav
従	runf
僞	eeww
懾	yaaa
漋	icew
鴿	yroe
槦	fuxw
堮	hlls
暡	jtvx
錫	wjwt
礩	deem
莯	sifv
筽	qlfg
嘐	lxxt
牷	wtgn
祻	hndg
涢	ilkb
銜	rwah
嚲	ovld
蹷	suxn
漬	ihmb
腎	sbwy
斕	pkfu
蘐	sueb
匁	wwly
薁	srpg
琫	ggao
艦	qsqm
賖	mtff
慚	ygej
灈	immw
罒	mww
氄	cqkr
甝	mssi
恴	ojyi
颺	rjft
榚	fuuo
跕	nmlv
紬	bkos
嚘	ldwe
祬	hhks
啀	lshh
卩	xjj
唒	lgov
縗	bofr
汒	iuws
鶡	jwtr
裖	psny
嗹	lgpd
柵	fncv
峫	jhcj
驲	xjrm
饐	yhyu
瀵	ipjt
逹	hudp
僯	epra
豷	dhyu
喢	lwrj
玾	gkjn
媿	cwun
跰	nusj
廹	exnb
颱	rvlv
骾	mfjw
騞	dddh
柲	fyqp
凚	sffh
砡	dgod
鞕	gfjw
舎	thlv
仴	ewye
淍	iwhl
鵙	mrob
痙	pfvf
伓	edue
挍	aotw
畊	jsti
揢	aoel
猯	rjsr
仭	ebod
驖	ddgg
氕	qqpq
偋	ebus
膢	wldc
髩	haxv
鳉	qura
絻	bylq
鼩	rbwl
粦	prao
罛	mquw
洟	igvg
抲	aalv
塈	xvgh
烸	uqbm
獽	rolr
棧	fggg
暘	jjft
灺	ucyo
咮	lwti
萹	sinc
柂	fqcy
蹆	nvpd
秈	rjsh
漅	ivjf
朖	wovn
蟞	umtk
鑵	wslw
佁	evlv
誎	uflv
媻	qqcn
铴	tivt
蒎	sier
蕀	sfkk
逥	nnsp
汈	ivfi
鴟	taor
霤	dtjt
蒍	soww
閧	ksti
詖	uvpa
搇	ator
虰	kanc
庲	udlu
鷇	hfro
帰	uxym
狖	rpxq
欃	fylo
踠	norv
貍	ykkk
莈	siqh
瘣	pwub
亁	djhv
誆	uggn
憕	ybfu
隣	cpra
鈅	wwyj
珢	gvnn
箏	qexv
綷	botd
蠤	ugkk
棡	fkuj
懃	gsxy
孹	blov
齶	mlls
衭	pguy
俥	egce
犲	raqp
諱	ucia
箾	qmwm
瑽	grtn
壈	honr
巛	vcc
罳	mjyi
苠	scai
鋸	wbdg
戄	ymmb
亠	obbb
檍	fijy
埫	hnst
葯	sbwo
慼	dkmy
誠	udvi
纙	bmbw
铕	tswy
苼	swgj
楺	fcqf
墆	hsfm
泒	iqus
懰	ytwm
蠎	ksgs
祽	hotd
柆	fidv
誩	uuaa
埰	hefv
薾	sftw
獈	rutm
兂	gqrf
貿	tmbm
儦	eiuo
鹀	ftty
娳	crmd
蠔	kods
飡	sysi
飀	rtjt
嚱	lmfg
姌	ckht
媬	celf
覗	vflm
撓	ahhh
澗	ikjr
磜	dwhs
姡	cren
埢	hugv
鬛	hnwb
庝	uesi
鬢	hofm
脋	bbbw
帟	pmvi
蘹	syor
竴	iuga
觧	ytug
偘	elll
覬	jflm
滌	ienf
梡	fofh
翺	tssx
膧	wikk
岰	jvxk
胈	wsbo
簔	qofr
観	qfwm
郂	ocji
鳯	qroj
謅	uwxx
癆	puux
悗	yylq
鵫	mjro
捄	afko
鋡	wtol
娫	cqnx
僼	eksu
撗	askt
鳣	qonf
邇	ftmp
脄	wsuo
麰	devw
呾	ljfi
霡	dwok
瀆	ihmm
垵	hocn
糦	phll
硠	dovn
磠	dklh
哻	ljhg
蝨	vdkk
袇	pwob
匜	gcyf
藹	sujx
耎	sgdr
睕	morv
萡	sieb
焞	uovk
鵄	hrok
勚	hkxk
臅	wmwk
鋳	wdac
雑	yfwi
蹣	nsfr
詰	uhlv
繈	bvvk
蛻	ktlq
鳮	brou
籫	qwqm
婬	ceen
壌	hotr
饗	vqoy
鈞	wwsi
閥	kegg
楜	fdwy
玞	ggun
亽	tode
巆	juul
膴	wqsu
凟	shmm
鶒	flxr
瑴	hfgn
睟	motd
毑	bcym
澙	irsu
墈	hdxx
棸	abfv
郉	hhcj
慱	ygac
柎	feac
矱	qswb
嵑	jjwx
磣	dvvt
鸀	mwkr
蝯	kehb
埑	aeht
齎	ounm
臛	wdwi
煟	ujwy
遱	ldlp
轄	godl
虒	emuj
噰	lovw
涗	itlq
蚖	kfhw
檇	fwkf
謞	uola
睎	mwsm
劏	njmd
鮣	ttfx
眹	mugd
訄	yuaf
屽	jhgs
販	mebu
愐	ygii
醝	gufo
罶	mtjt
瞷	mkjr
鳽	fsro
胾	dgkt
鄈	bfgc
袺	phlv
鶵	wxwr
貶	mqpe
怚	ymii
窵	prox
簝	qgum
燬	urfq
卭	fxjo
箋	qggg
扊	iuuo
譑	uell
竂	pgum
誑	urgn
濴	iuuk
瞏	mhlr
醧	ggll
廄	uxvq
礫	devf
灴	ufoo
氃	ikrm
畺	fjff
闡	klld
搲	apqu
嗰	lend
鶀	rdjo
砠	dmih
稕	rovk
鮆	nrty
鶌	bxxr
鍖	wdxi
駔	dmim
酖	gyqr
脃	wycb
鵷	orvr
喥	lusb
謄	wugu
嵣	juxl
慅	ybok
犑	wmsq
橞	fgyi
忋	ybji
慟	ywkx
瀽	iosn
罫	mhhm
姟	coin
齄	tjaf
缻	wawo
呰	nrlv
錿	wmuj
鼒	aqmt
厡	sekv
膯	wbfu
蕫	sikk
妔	coqj
唂	lttl
啋	lefv
哷	leac
琲	glin
埶	htho
炡	ufni
瑡	gyfm
鋎	wofh
蓨	senw
懐	yomr
蠠	gkkc
惄	kmby
薭	srwd
怗	ymlv
紆	bfau
冋	klvf
腒	wbdg
仛	eqai
饟	yolr
醙	grnb
犡	wssk
伇	eqhe
晱	juuo
岒	jtov
逎	gpdo
廼	dxnx
闝	kmeh
舕	ruuo
縁	bxds
輻	gflj
蔿	seww
鱬	tdsr
篯	qtfg
鶛	rrer
劊	tfjm
挀	aery
魜	ttey
斵	tfje
嚰	lpdh
繾	blkp
砅	dkvh
鳑	qouo
扤	ahwo
緘	bdfl
觡	ytel
襶	pdgt
悆	tffy
榎	fdme
遶	hhhp
戝	mggb
禐	hehb
訟	utvv
坆	heht
籑	qmgv
竇	phmm
荙	sgpd
夑	uuue
蒮	sywi
赥	htte
跁	ncbv
陑	csrj
葏	sixa
揘	aegn
鯈	enet
篔	qlmb
淈	ibxx
壊	hdmr
鳠	qswb
筶	qwlv
斎	pths
杴	feiv
睳	mghh
洝	iocn
捰	ajfv
炴	ukgd
庱	uhte
傃	ehbs
諳	uijr
眴	mwjr
檊	fdjh
觴	ytqt
偮	elar
鵌	rtff
羭	utfm
攦	afki
絝	bgfs
斄	hesd
繳	beoe
讄	ujjj
飱	frys
焝	utaj
僩	ekwy
鷮	elkr
呅	lpwv
殝	frgr
魎	wfmr
鵅	elro
幓	mvvt
謩	sjgu
聇	afni
籇	qods
岨	jmis
烇	utgn
帡	musj
癊	pctv
頚	bhdm
赯	httl
垇	hkfi
悊	aeyi
鋉	wflv
垰	hkak
皠	ejwi
翍	xxvp
痏	pswy
禢	hjxx
褘	pciy
澘	iffj
躂	nhup
踛	nhth
橢	fcsw
歵	nhmb
醹	gdsr
鐡	wdgu
黽	jmm
娗	cexn
茚	stfx
慔	ysjg
潯	ixfa
煃	ughh
澩	rwwk
鴡	mroi
鳪	mroo
搳	aodl
踤	notd
掑	adjo
篸	qvvt
咺	lfjf
殞	frlm
崕	jshh
鵸	galr
廩	uonr
顟	xxtm
偟	eegn
咘	lsmv
洅	igkf
駑	cbdm
擉	amwk
嚾	lslw
慫	rtty
鼵	rbps
瞼	mrlf
帗	msbo
噈	lomd
餟	ybbb
箁	qilv
癿	exib
馞	rjdv
煯	urre
鷑	qiro
褩	qqor
醡	gpqm
虅	swud
禴	hyln
暦	sffj
嫲	cpan
噅	leww
麅	iwck
韏	ugci
輓	gylq
倈	edle
蕚	slls
抭	aoqj
塁	jssh
恌	yqss
錋	wwwy
蝱	ukkc
嶶	jrfq
滺	ieny
羱	usem
鸓	jjjr
鏄	wgac
鋂	wqbm
陁	cqcy
覌	bmxu
盺	mejf
凔	stol
漟	inht
歈	tfwe
銶	wfko
颩	rtof
匋	wwoy
鵁	otwr
墠	hlld
愞	ysgd
轏	gbvv
坧	hdht
浧	ilgn
勠	xxtx
髳	hcqp
羾	xxfo
櫉	fsha
穨	rqlm
忔	yqvi
茦	sfkf
秨	rqmo
歂	jsei
誜	uvte
嶳	jdhh
皪	eevf
諝	uvnw
瞉	hfmf
敼	hlub
迌	wpdy
臽	yrjm
鱄	tgac
敨	ileh
飬	ugov
鏻	wpra
灒	iwqm
桟	fsgg
鵾	jrrr
毰	rilv
裓	pgsj
銍	whkj
氶	vkvi
騐	dtoy
瓽	naws
涳	ipfo
矼	dfoh
耤	dtsj
糹	bsss
嶦	jysu
幇	hham
鶅	vjro
頣	sdmb
藳	sorh
耮	dtux
暉	jygc
粌	pvns
団	nacw
浖	ieac
黗	naxg
涾	ikjr
黲	nvvt
耬	dtlc
橾	fllf
虵	kcyc
纎	bdgf
鞺	gnht
輿	rgft
勛	lmxk
穔	rskt
疎	vnfl
樻	flkm
笯	qcbu
濗	isjm
褦	pvwr
懤	yhva
摻	avvt
衏	rfha
蒧	sdml
鮛	tkma
牓	touo
絳	beao
亅	viii
烢	uoqa
芀	sbdj
叧	lbdv
鹠	tjya
氉	lllr
鸋	oymr
滷	ikls
琸	gmjd
趹	nbte
扲	atov
詄	uqgu
玓	gwod
檵	fvvx
旹	xfjr
廮	ummc
穵	pvix
鴢	vxro
汚	isxi
筰	qeqm
鶋	bdro
艎	qegn
灀	idfm
兤	mhut
柀	fvpv
糀	pser
刦	hvmd
鋥	wlgn
歝	mhue
餲	yjwx
膭	wlkm
騧	dnam
蒞	siei
窼	pvjf
矨	qeoi
絏	bkqp
徏	rnma
頦	odmb
叕	bbbb
犘	pwna
堧	hsgd
渇	ijwr
嗩	lmmb
虌	sumj
癹	bqhu
鵟	rgro
屩	brel
鴛	rvro
醕	gojr
梘	fmxv
霩	dovc
髪	hsbu
緅	babu
迊	fmpd
搉	aywi
漰	ijww
軱	gquc
蚠	tbkc
舩	qtvv
楟	foan
綖	bqnx
纴	vens
鯭	tvmn
誥	uwlv
閨	khht
藷	suhj
虷	khgc
焴	uovw
逴	mjpd
盕	iqom
汌	iqcs
懫	yeem
嫺	ckwy
彍	vust
栐	fokv
鍀	wjfa
窞	pyrj
痑	prrk
恜	ygfo
轀	gntm
礚	dshm
簼	qash
鴽	clro
儂	ekss
藪	slde
羣	xqlu
捸	axkv
庪	uadb
慩	ygpd
砯	dokv
邟	oqcj
幍	merj
菮	suxt
躱	wvfv
棃	rwqf
蘗	sblf
榙	fsye
鏤	wldc
莚	sqnx
闘	kfla
睙	misq
鱇	tuxk
鴗	irod
鲕	qsry
抋	ayio
輶	gugo
繘	bcql
鵞	qagr
鉗	wssi
猧	rnaq
劘	plmd
殤	frqt
忚	ycyi
殾	hjqh
墶	hhup
鐸	wmhd
幎	myjt
閘	kkjn
訉	uqod
蹌	ntol
祃	hxms
磼	dwfv
汵	itov
嶔	jwei
薖	snpd
齜	mnri
雗	djqw
吷	lbte
鮕	tdgy
冫	siii
驢	dmjm
弙	vfau
駒	dwlv
帎	myqr
諶	udxi
襢	ponf
螻	kldc
嘽	llld
鵵	ylqr
紽	bori
斨	xejp
儗	erqn
癝	ponh
驛	dmhd
誂	uqss
礕	blod
宖	ovvv
悮	ylfg
榥	fjmh
枃	fwsi
琣	gilv
媖	cskg
尟	jfnq
燫	uuut
刼	hvbo
胊	wwlv
婁	ldlc
倴	egds
禡	hdms
莢	sgtt
蛖	kdto
蕥	shwi
皚	ejfu
蒱	safu
忹	ygni
雟	xwkl
蘷	sfne
悕	ywsm
馝	rjyq
瞯	mkwy
錽	wfue
鐍	wcql
毉	gqqt
搨	ajxx
鬎	hflm
阹	chvv
瑓	gfnu
貲	nrmb
槀	ofvl
繕	buul
漴	ijoh
藂	sabs
濘	ioya
夊	ehhh
溕	iyfd
檖	fudp
彐	xll
簚	qmgm
鉁	wtto
豲	dsem
稯	rwxe
緯	bcis
氿	iyfs
輀	gsrc
斮	sjej
髷	hksj
魛	tbdy
倰	ehte
餸	yugp
鯁	tfjw
伡	ehce
獩	rndm
泏	ixxg
篺	qawd
螾	koft
鶏	egro
嵍	cqej
兦	rxiu
偸	erfv
薊	stmd
禲	hssk
嚵	lylo
摪	axwa
邘	facj
窻	prey
娍	cdvi
鼃	hhjm
醷	gijy
崀	jovn
撹	aiym
薢	sytw
璚	gcql
甿	juwt
闓	kjfu
胣	wqcy
呌	lsdi
沕	iwto
醤	ueag
傔	euxt
媮	ctfm
鄮	tmcj
巺	ccft
夣	ovmr
缾	wusj
埨	htfn
縹	bdhs
郼	ccji
鉼	wusj
犵	rqvi
鶯	uuyr
迼	hlpd
鋬	aebw
餻	yuuo
巓	jrmm
癑	pkss
韖	ccqf
酔	gydi
嵗	jdfm
鵮	yrro
錡	wgal
砶	debh
蹳	nbvq
緺	bnas
粬	pksj
侒	eocn
鲉	qkoy
摖	awhs
賄	mswy
漙	igac
暳	jddx
緛	bsgd
弰	vmwy
撣	alld
慳	ysbh
瑐	guwm
膞	wgac
惢	yyyi
哵	llxm
膗	wjwi
煻	uuxl
鳋	qbok
獂	rsem
瑝	gegn
赩	httc
妌	csti
噋	love
寕	odma
琗	gotd
兿	uayv
蟫	kdjd
繹	bmhd
餌	yars
爼	wwmi
抩	akht
脛	wfvf
桭	fsnv
樺	fshs
耇	hwlv
腁	wqhh
儻	enne
禜	uuyh
檚	fffn
椄	ficn
箆	qktr
硩	aedh
襠	pnjt
枟	fsvv
迠	mlpd
錨	wsjt
砄	dbte
鏣	wusu
鍮	wtfm
阤	ccyj
鼫	rbdh
醸	gotr
慲	ysfr
抣	awsi
苭	svxk
鄷	ksfc
趬	dhhh
隤	clkm
郷	vqxc
蕠	sclb
駪	dwqr
敔	fcle
煬	ujft
郚	fclc
鯢	trqr
抏	afhw
兣	dqsk
艭	qwwb
誨	uqbm
鮪	tswy
鞉	gqss
渕	iugm
岥	jvps
挭	afjw
栔	dbfv
籦	qwwk
膍	wrwr
溞	ibok
鸐	xxwr
倎	ekst
嗺	ljwi
猘	rwkm
剣	ytmd
貆	yfjf
歟	rske
棙	fisq
匉	whue
蟬	klld
踳	ngjr
労	iyxk
鷣	djro
黤	ngkd
袦	pxxg
訐	uhga
崱	jmmd
棝	fndg
瓀	gdsr
甹	ksko
鷵	bhjr
诇	oklv
旴	jfau
钁	wmmb
漛	iugk
笒	qtov
朶	vfvj
旽	jaxg
粖	phom
撶	ashs
荂	sgfs
灤	iubf
陃	cfkt
翫	xxeh
駞	dqcy
誒	uvqi
浕	ibos
柅	fbri
螀	urak
烣	usuo
羆	mvwu
韷	ijxx
獳	rdsr
鸉	fjfr
礔	dblo
僤	elld
霦	dfft
晄	jmhw
焻	ujjr
椲	fciv
軨	gtob
箑	qfxn
忴	ytov
禼	mnwv
煱	unao
婭	cfja
摶	agac
笻	qfxj
謋	uraf
跱	nhac
讱	obod
鱖	tsue
箘	qnrh
躠	syon
鉰	wvfl
輹	gqje
堊	fjht
玤	gdnn
蠂	kshf
髝	ouux
渓	iegu
閂	kfin
婓	lcni
裐	plwy
鏓	wrey
鉾	wvwn
擪	sjwt
眰	mhkf
莁	sftt
鋤	wmxk
湪	ibds
啌	lpfo
滭	ijsa
峐	jois
臚	wmjm
娙	cfvf
槙	fdmt
覻	mflm
蓃	srnb
磇	drwr
懟	kuay
琞	jwgo
暩	jwhs
朾	fanv
沑	ibcs
諄	uovk
渙	iykg
齏	ounf
韲	ounf
篩	qyfm
継	bpxi
鍬	wruo
爟	uslw
繦	bvlk
瀺	iylo
儬	ehwm
鉛	wqlv
児	njqr
謷	hweu
纑	bmjm
苲	sqmo
猵	rinc
蠜	fwwk
蜨	kfxn
驁	hwed
纕	bolr
扨	abod
罎	wjdv
觭	ytgl
靯	ghte
鸼	qyao
嗇	httl
犢	whmm
觟	ythh
鑣	wiuo
瘓	pykg
讖	uttf
屧	brhf
秥	rmlv
僶	ejme
瀓	irfg
馡	rjli
觿	ytjl
偒	ejft
鶔	cqfr
噺	life
禣	hfac
桮	fdlv
枮	fmlv
齌	ounu
皫	eiuo
癥	prfg
斀	mwkb
溎	ifhh
掕	ahte
蕯	scew
牗	tuxw
趍	drrk
扖	aruo
傫	ejbs
荓	susj
鼇	hwej
褽	bhar
旑	ogal
璲	gudp
鼔	hlub
縧	benf
褁	jfry
趗	dnvk
諴	udfl
襾	dxxx
勦	vjfx
棈	fhwy
龤	ylle
虖	mqua
澟	ionr
爂	rkfu
夻	glvd
鬉	hwxe
餈	seys
鯉	tkky
錎	wyrj
鑚	wggm
毾	jxxr
灂	iema
鼸	rbut
翧	ofjx
誃	urrk
攬	asqm
颬	rhyf
鐕	wgqj
賮	xfum
忼	yoqj
宷	oqpm
廐	uxvq
掽	aukg
衞	rcla
噸	laxm
嚶	lmmc
鋮	wdvi
駓	ddfi
慛	yjwi
撛	apra
桚	fvrk
佋	eblv
椝	gkfv
旙	oqpj
箣	qfkm
癵	pubt
懴	ydgf
蹏	nemu
麖	ioma
嵺	jxxt
敃	caeh
弸	vwwy
忟	ypwi
翖	yxxi
衱	pvod
揓	aoqc
衘	rqfa
迆	cpdy
躨	nute
邥	yqcj
祾	hhte
寏	oykg
溇	ipcn
夆	ednh
嶄	jgej
梣	fjtv
輅	gelv
柣	fqgu
唥	lstb
鼣	rbsq
駬	darm
瓐	gmjm
刐	womd
箥	qivp
癬	ptug
膵	wsod
秼	rwti
桍	fgfs
鵋	byro
詾	uwwx
咡	larv
搤	autm
呍	lsvv
陗	cmwy
癰	pvlw
尗	kmas
溄	ijea
鋗	wlwy
賂	melv
餉	yrns
慴	yxxe
転	gsvv
漘	iswy
綅	bxyb
顡	iddm
嶛	jgum
鬐	hhrj
溋	ivbm
醲	gkss
謓	udmt
綳	bwwy
吤	ltti
麉	hhil
癅	pagj
貣	gmby
皯	vhgp
柛	fkev
嵒	lllj
擰	aoya
玍	qhtk
梴	fqnx
煥	uykg
圤	hmot
筓	qhhg
咃	lecy
侐	eqmn
媕	cysj
纞	buby
秔	roqj
訔	juas
芺	seoj
鉔	wgmv
檯	fhlh
謐	uyqm
獆	regd
笀	quwk
癠	pous
柪	fvxk
溓	iuxt
綄	bofh
埧	hmti
苢	sbbu
龂	ntxe
鮌	tovo
嬎	cylw
覔	dmxu
蟌	krey
丄	ksss
媥	cinc
燸	udsr
馿	diem
懹	yolr
惪	dmyi
乁	viii
覣	rcmx
杸	fqhv
漒	ivlk
昤	jtob
熤	uxxi
膇	wypd
裌	pgtt
飃	rdhs
傛	eptl
嚢	dlyr
鲺	qvqk
焣	abuo
鏔	woft
邷	acjw
簶	qhxk
廈	udme
汦	itai
盨	tdmm
咢	llfs
瑦	gywn
覅	dcwt
諦	uoum
剰	rsmd
枆	frmv
噂	luga
帞	mdjr
朿	fkfv
賈	dmbx
覈	deoe
厷	svvo
魊	wglf
唍	lofh
軔	gbod
涖	ieid
裿	pgal
祋	hqhs
鄨	umtc
塀	hbus
輼	gjmn
圀	ntog
垝	hysv
鸔	rjsk
蹜	noej
暵	jsfg
髞	ollf
毃	oqhl
澫	isky
鞈	gyee
鶄	hwro
匼	gyef
鼈	umtj
騹	dgsi
豀	ttlg
谾	ttlf
胉	weby
凾	vlbx
芚	saxg
鲖	qkfl
穏	rexy
奵	cann
砆	dguh
洭	iggn
憲	odmy
凓	sdfv
豘	daxg
洰	igbu
刵	amdr
鼛	hlul
縐	bwxx
僑	eell
耏	stor
聶	aaar
耾	asvv
纆	bnht
璒	gbfu
蕎	sell
朌	wtbd
脝	wovl
鲴	qndg
朜	wovk
獣	ijfs
絅	bklv
稑	rhth
儺	esfw
癘	psky
鸚	mmcr
铔	taue
駴	dgsj
鲯	qdjy
氀	ldlr
僾	eeye
樕	ffle
頜	ydmb
趽	nogv
糱	xyop
厞	slih
疕	prib
猺	rewo
偺	eemj
膿	wkss
仸	eeoe
辤	eybo
蟕	knrt
筬	qdvi
羓	ucbg
鼱	rbhw
煄	uwkk
薋	ssem
贔	mmmb
谺	ttlh
訥	ukte
贛	ijem
愵	yvss
鉲	wkmo
縏	qqbs
懝	yrqn
徯	revg
謧	upxv
餠	yqhh
韾	hbqj
犎	hhaw
鎁	wacj
婘	cugv
皜	eolb
礨	jjjd
寉	owib
芐	sakj
軸	gkoc
曕	jysu
礮	ddow
崵	jjft
聾	iwma
粻	pham
磒	dlmb
眜	mhof
鳡	qdfy
淽	isni
鳩	yrof
蚎	kjrc
誳	ubxx
慯	yqjt
攖	ammc
薔	shtl
盌	rvmn
皭	eema
戇	ijey
倃	eeml
鎛	wfac
瓟	qwck
窽	prqe
汷	iehs
晇	jgfs
詺	urlv
熞	usbh
腯	wedm
寗	oyqh
袏	psfo
鏉	wfle
頾	tdmr
軵	geac
碮	djfn
鸄	eoer
鶗	jfnr
傪	evvt
倄	ewsw
讁	uoup
礘	djvu
屼	jhws
痵	prvk
酑	gfau
峬	jfus
纇	pbdm
鴮	gfsr
姩	cqao
俈	ewlv
簆	qofb
謗	uouo
殯	from
濾	imjy
逓	esmp
筈	qrek
銢	wskv
蜄	ksnc
譵	ukua
膹	wdsm
鵿	rjqs
鴍	prow
伵	enqr
鶽	wdro
肨	wdny
鑀	weye
嬪	cofm
鴔	qpro
嫙	coqn
瀖	idwi
颣	pbdk
烮	frmu
譒	uqpj
艗	qutm
蜲	krcn
蟎	ksfr
娋	cmwy
鉚	wtmj
榗	fauj
偫	erha
儜	eoya
嫾	cpra
爓	ukyr
釟	wtij
錬	wfjr
鞵	gevg
蜁	kqvn
瓆	geem
錉	wtaj
譂	ulld
粍	prmm
誻	ukjr
誽	urqr
巎	jdme
謱	uldc
岧	jblv
蠨	ksxf
崸	jdmb
伭	eovo
鵗	wsmr
詷	ukfl
冐	kswy
慙	geyi
鲹	qvgt
麔	ieml
喌	lliq
傚	eote
釂	gema
妵	cogn
溤	idms
諰	ujyi
鑕	weem
暔	jdkd
堥	cqeh
鶾	djqr
銾	wfkv
蟏	ksxt
嫭	cmqa
朎	wtob
蝡	ksgd
儴	eolr
硙	djbj
姴	frmc
篏	qsse
褷	prnn
籿	pacm
敎	wsve
珷	gfgn
穈	prha
腜	wssf
靋	disn
筄	qqss
鱎	tell
孆	cmmc
栁	frxj
馹	djrm
膎	wevg
佹	eysv
鵧	usro
牕	trey
讌	usfu
魣	tcuy
鑬	wsqm
鳻	tbro
黁	prjr
皃	eqrb
昸	jesi
鰍	truo
皗	ewhl
垔	dhtx
桇	clfv
犕	wsqt
箛	qvqu
儃	eonf
胕	weac
籘	qwub
鼉	lljj
焆	ulwy
籨	qrei
粯	pmxm
兾	ujst
泜	itao
槂	fvqb
鄛	vjfc
濅	ioxb
溈	ioww
廵	vxnc
峮	jxql
屴	jxks
硜	dfvf
盭	vhum
碶	ddbg
戩	fvvg
棊	dfvj
涽	itaj
悳	dmxy
勥	vlkx
剻	jwwm
橉	fpra
竉	piwm
槮	fvvt
朩	fvvv
韙	jfnc
霿	dcqm
敇	fkeh
霚	dcqe
乭	dvih
諑	udod
椑	fwdi
鯤	tjrr
詫	uoqa
羬	udfl
嶍	jxxe
単	ijdi
檝	flag
猼	rfac
汱	isqs
趝	dtoy
巠	fvfo
嶰	jytw
鵛	fvfr
濿	issk
糑	pvss
誋	ubyi
鴾	vwro
鰅	tkyy
煒	ucio
枏	fksi
騋	ddlm
唖	lalf
杍	fvkv
鷅	dfro
鱧	tksu
濸	istl
暅	jyff
閩	kkcn
襅	pjsa
勲	wkxu
疁	jxxt
砳	ddhh
盚	fkom
鵠	wlro
鶹	tjro
鉞	wgxi
鶦	dwro
籕	qftj
楤	fwty
徸	rikk
弣	veac
鑢	wmjy
澊	iuga
昅	jvod
瀁	iugv
騝	dxax
湴	iukg
楄	finc
涍	ihvk
唭	ldjv
槞	fikd
燓	fwwu
灔	iksc
猍	rdlq
徠	rdlc
呇	klvv
鴩	qgro
滸	iuqd
桜	ficn
浾	ihtt
桪	fxac
鷜	ldlr
霫	dxxe
銸	waxi
榯	fjha
檻	fsqm
鉙	wlti
噊	lcql
楬	fjwx
譳	udsr
庬	udto
汃	itis
樆	fpxv
攰	dbxk
锠	tjjr
鷏	dmtr
馭	dbum
銕	wgvg
誖	udyv
鹺	kufo
潡	iove
鑼	wmbw
刴	vfmd
焤	ueau
趡	dwik
瘚	puxe
硞	dwlv
崟	jwjs
趘	dbrm
鑷	waaa
椈	fwpm
竝	iidd
蝁	fjkc
鐶	wmfr
瀏	itwm
簳	qdjh
螐	kywc
鶟	psro
礖	drst
椃	fmuv
彺	rgnc
瀲	ireh
絫	vvvb
稢	rglf
闕	kuxe
鶆	drol
鴀	drou
鰎	txax
辵	tnfo
漄	ijsh
澰	irls
鍉	wjfn
漇	irnn
蠏	kytw
鼂	jfjm
痽	pwib
鮟	tocn
螆	kuvv
棔	ftaj
螝	kwuc
麨	demq
砊	doqj
銬	whsk
閮	kexn
鯽	txvx
渂	ijpw
鰼	txxe
泬	ipxs
帀	fmvi
臕	wiuo
亷	iqxt
錆	whwy
钑	tvod
蛣	khlv
砇	dpwh
痟	pmwy
矺	dqai
颕	rhdk
蠿	vvfk
鈩	wiej
狘	rgxi
厀	ftkx
窂	pwnx
鰶	twhs
釡	twji
橖	fnfv
毧	rgso
閞	kvsj
鮈	twlv
鸍	ftmr
鏕	wilj
涐	iqag
雽	dqua
禸	kvvf
鮂	tnte
朲	ftev
獉	rgrh
鱨	tnrj
鰬	tmpw
鮯	tyey
蜪	kwwo
鹝	flky
奱	ubbg
穲	rfki
稛	rnrh
憖	dsyi
溡	ijha
鸞	ubbr
麐	iplv
渨	ijgf
麫	deax
胦	wkgd
褃	pnwy
蟓	kyld
盁	vmnj
彡	too
溰	ijfu
梛	fvac
鶝	fljr
謴	ubdm
覸	kjmx
簙	qdfa
璗	ijfo
廦	ublo
贕	toom
襂	pvvt
蝃	kbbb
趤	dodh
痌	pkfl
橔	fove
洣	ipms
鮸	tylq
癇	pkwy
椊	fotd
鄊	vqac
櫥	fuha
剢	domd
鰂	tmmd
魓	wjsa
欍	fswr
阓	plkk
蚹	keac
艍	qbdg
鑤	wjsk
舠	qbdo
腨	wjsr
螘	kjfu
顑	dflm
檥	fuqg
弶	voma
窶	pldc
孮	vohs
斚	vvyd
鏙	wjwi
檨	fuse
栟	fusj
鯨	toma
靉	dsve
硋	doih
靆	dsvp
逈	rpdn
硄	dmhw
魿	ttob
鋄	wfub
肁	ixao
驒	dlld
岝	jqmo
鋞	wfvf
庤	uhac
輮	gcqf
爕	uuuu
槪	ferq
諜	uhfv
鷎	egdr
窚	pdvi
魠	tqai
涒	ixql
樥	fsed
炚	juor
啩	lhhm
詍	uhia
媌	csjt
閡	koin
楥	fehb
郶	illc
桻	fedn
滆	ifln
襘	ptfj
覢	uumx
煔	uuml
癐	ptfj
廧	uhtl
勌	ugvx
俓	efvf
粚	pqcy
枑	ffbm
靭	gbod
膋	uuyw
靱	gbod
筁	qksj
囀	lgga
鼮	rbex
脌	wqao
鯆	tfuy
灪	ifwt
喕	lgiv
鼨	rbes
羢	ugso
鼶	rbem
渹	iwua
焭	uuyq
潐	iwuo
佂	efni
痗	pqbm
脻	wfxn
鯗	ugty
袘	pqcy
窌	ptmx
篬	qtol
誶	uotd
淜	iwwy
弮	ugvg
儞	eftw
爀	uhtt
醎	gdfl
崪	jotd
氼	ktev
鋵	wrqj
箎	qmuk
騁	dksk
腉	wrqr
鍇	wrre
傰	ejww
膬	wrrr
杝	fcyv
簘	qxpt
袽	pclv
諟	ujfn
簂	qngf
臝	ujfv
鎫	wrwe
譮	utfj
殏	frfo
啺	ljft
簹	qnjt
魌	wdju
铥	tevv
詆	utao
梮	fbvl
蚔	ktai
溵	iexq
諯	ujsr
簱	qodj
粓	pssi
铹	tsyx
閼	kots
劗	wqwm
衊	qmso
熷	uujj
簒	qmgv
栄	iyfv
岮	jori
胏	wqxq
婲	cser
艫	qmjm
伻	ehue
胻	wrah
癗	pdjt
腇	wrcn
煫	uuds
夲	gdid
昹	jokv
猦	rrfq
竚	ioan
礏	dkut
鈃	wfsj
碙	dkuj
鉌	wrhj
櫫	dhjf
櫺	fdll
姠	crnn
箵	qmqm
嬐	crln
坒	rrht
廯	utug
霝	dlll
譀	uvae
汮	iwsi
鞏	fqog
簗	qibf
瀋	ioqj
浻	iktl
諫	ufnu
蛓	dgkc
佀	ebbu
牳	wbmn
湑	ivnw
腙	wohs
崳	jtfm
沇	ivqr
隀	cwkk
鶶	uxlr
羥	ufvf
樞	fgll
鼲	rbyg
肕	wbod
峟	jswy
燖	uxfa
鮭	thht
橎	fqpj
煡	uxax
恏	cvyi
伃	ecue
闃	kmsq
嗘	levg
鷷	ugar
謵	uxxe
涱	ihas
蠺	fgfk
鯥	thth
檮	fhva
鈦	wgod
檣	fhtl
怘	dyig
惎	dyij
暛	jufo
岇	jtxj
妉	cyqr
牜	wnnn
膼	wnpd
槢	fxxe
郣	dyvc
闤	kmfr
碆	ivdh
腛	wbhk
煏	uflj
鳹	tovr
湗	ihha
碀	dyxv
臷	dghk
瀫	ihfb
谹	ttlv
鉊	wblv
襚	pudp
夅	eaoh
謬	uxxt
燲	uxxm
鈛	wggj
晎	jsti
僫	efjy
篅	qjsr
哣	lflu
醊	gbbb
濏	iggq
鷀	uvvr
龘	iwmm
鑔	wowh
鼰	rbmb
儌	eeoe
糐	pfac
鵀	eero
汋	iwod
侹	eexn
櫴	fflm
徥	rjfn
粵	rqps
賷	dllm
暰	jrtn
嵷	jrtn
鄅	qkkc
螶	gbkk
烖	dguo
鵴	wpro
熸	ugqj
覦	tfwm
艃	qkko
鼭	rbha
楕	fsfw
斉	ptsi
犉	wovk
嗂	lewo
壟	iwmh
謉	uwua
鴃	rbte
杕	fgdv
曞	jssk
烍	uwqr
鶞	edmr
灊	igqn
僲	edra
鼤	rbpw
馽	dlns
駄	dgod
剸	gamd
竏	iwkd
湩	iwkk
雘	wosb
鶬	toxr
鷒	garo
襳	pttf
泃	iwlv
竘	iwlv
諀	uwdi
濈	ilag
窲	ppsd
阠	cvdi
溙	igkv
篳	qjsa
伒	eeje
仮	eebu
嘫	lwsu
芲	stri
鄔	ycjw
鋭	wulq
屢	bldc
軥	gwlv
弆	hvsj
瞔	mhmb
囌	lstr
搝	atsq
蕑	skwy
紩	bqgu
罌	mmwo
欿	yrei
歜	mwke
鵺	oerr
觤	ytyv
茿	sfqo
姸	chhg
鄼	ggmc
鬙	hujj
蕘	shhh
渘	icqf
皻	mmvp
攏	aiwm
怞	ykoi
帓	mhov
揕	adxi
憹	ykss
毱	rwpm
臹	hdvi
茘	sbbb
嬈	chhh
苪	sfkt
奿	yocn
葾	srvy
匟	goqj
贀	gqqm
蒬	syyo
鬩	nrqr
埲	hgao
彛	xpts
弉	xhsj
丼	sobj
顇	ottm
跍	ndgv
忈	syii
掍	ajrr
掄	atfn
跈	ntto
穋	rxxt
瓪	aebu
琋	gwsm
墫	huga
悀	ybtn
翽	ndfx
抸	aqpe
覍	mmxa
轣	gsrn
贜	msgs
紺	bssi
惽	ycaj
怋	ycai
湋	icis
畵	xhjx
憪	ykwy
蒁	sfop
咜	lori
鵱	hthr
摿	atij
妋	cgun
琟	gwin
鼚	hluh
鼘	hluf
徔	rspe
竪	sbid
鈉	wkte
挆	aqfv
蹫	ncql
覰	mmmx
媓	cegn
銻	wuvq
鬶	gkfn
咰	lwjr
葨	sjgf
茐	swto
幦	blom
唫	lwjv
奬	xwag
薌	svqc
髼	hedn
瓙	ghvu
钶	talv
壻	hvnw
蕧	srqe
辺	bpdd
葹	soqc
幟	mijg
迉	bpdh
縆	byff
萮	stfm
鳦	rvio
馮	sdmi
垏	hxao
邿	hacj
眣	mqgu
哫	lnvv
餼	yqpm
冚	yjsm
蒣	srtf
醘	ghvm
禯	hkss
挱	aimq
荄	soij
挘	amqx
擽	aevf
廽	nnsx
綍	bdyv
鸅	mhur
婜	sbcn
餄	yyes
譻	mmua
踂	naxi
酟	gmlv
囋	lwqm
縋	bypd
翜	xxgt
厤	srrh
耊	hhkt
縝	bdmt
珛	gswy
龕	yiwm
軪	gvxk
遉	mmpd
鴆	yqro
菒	sjfv
鶨	bdro
搃	auly
餡	yyrj
鞄	gwck
玸	gwck
觼	ytye
蔠	sbes
撧	abyc
藅	smum
汥	idbu
酧	goac
縶	hudb
叞	bhbu
鬳	mfln
抐	akte
祊	hogs
髄	mswp
頳	httm
瑥	gjmn
幏	mods
尌	hlua
凁	sflv
嬁	cbfu
萯	symb
餪	ysgd
骉	xxxm
緄	bjrr
轇	gxxt
虙	myqp
冪	ysjm
禕	hcis
羇	mggl
図	nswl
葂	sylx
妅	cfon
蘤	seew
轂	hfgc
眂	mtai
苆	sabd
囩	nsvv
騺	hudd
黮	ndxi
悂	yrrh
剳	symd
嗼	lsjg
朡	wwxe
恲	yusj
鴶	hlro
寳	ogym
墯	ysfh
堿	hdfl
喼	lyxy
撌	alkm
藗	sflp
鴐	xlro
囈	lshv
躣	nmmw
眿	mokv
垹	hdcj
袃	abor
禱	hhva
堔	hytf
綟	bisq
茷	segg
喰	lysv
娕	cflv
鳿	gron
恟	ywwx
薣	shlb
鳺	grou
囨	nduw
坢	huao
搙	asac
圛	nmhd
鳭	brod
埬	hfjr
鬊	hgjr
秇	ryod
翪	xxwe
囒	lsku
莬	sylq
埀	wurs
蘢	siwm
眓	mgxi
荮	svac
莤	sgoj
緉	bfmr
轕	gsjx
饍	yuul
撽	aeoe
懢	ysqm
鸙	yllr
龎	siwm
哰	lown
埣	hotd
鑞	wvnb
瞮	move
贓	mgxs
媔	cgin
掿	assl
讐	wwua
埻	hovk
娿	calc
憸	yrli
悧	yrmd
鈒	wvod
纚	bfki
墐	hgsi
郰	abcj
宼	ofhc
踑	ndjv
刌	amdc
薥	smwk
蘛	sdxw
豰	hfds
鷞	gwwr
璙	ggum
蘯	sijm
売	hyqr
嚁	lxxw
挏	akfl
鷢	suxr
蕋	snnn
彚	xyjf
摠	arey
璕	gxfa
輭	gsgd
甗	mfla
蒭	swxx
隬	cftw
蟨	suxk
帉	mtbd
鄏	sacj
瞡	mgmx
鶺	sstr
勯	onlx
蔕	ssfm
幨	mysu
擳	aqxx
頇	hdmb
顢	sfmm
屗	brac
瓂	gshm
捼	arcn
躉	sknv
慻	yugm
匵	ghmm
祰	hwlv
朥	wuux
櫱	xyof
噿	lxxd
慃	ytvx
薳	shlp
恑	yysv
縂	buly
觕	wytn
祶	huvq
瞃	medm
輳	ggfg
禌	huvv
藋	sxxw
聦	awty
蓴	sgac
眅	mebu
愩	yfmb
幝	mlld
嶇	jgll
罼	mjsa
鶭	boro
幱	mkfu
蒔	sjha
蒀	sjmn
稴	ruxt
鵽	bbbr
遰	sfyp
憺	yysu
湬	rukv
阫	cduj
纓	bmmc
揫	rutu
轷	hqua
媦	cjwy
撁	aovw
鑒	sqmw
鑋	gfvw
秢	rtob
蹹	nyxx
攋	aflm
鸆	mlfr
齟	mmic
娨	cjhg
餎	yelv
皵	sjvp
頨	xxdm
搹	afln
鸕	mjmr
輢	ggal
遅	bupd
塜	hyfd
蔪	sgej
繎	bwsu
鶠	gjcr
旝	oqtj
璖	gigf
餃	yotw
飫	yeos
鞟	govk
饑	yvvt
韜	cerj
匽	gjcn
攆	aggg
嫻	ckfv
苿	shej
稾	orhl
貳	gsmb
飈	ruuu
坣	nhts
揷	awrj
惵	yhfv
鷂	ewro
祤	hxxi
瓬	oawg
卽	erxj
鼟	hluu
匱	glkm
塴	hjww
祍	hens
叺	lruv
儉	erle
蕝	sbyc
葖	spsq
鷧	hyfr
歑	mque
靽	guao
歴	sffn
磯	dvvt
抂	agno
髺	hrea
飦	yhgs
镺	heoa
褢	owry
骳	mvpg
躃	nblo
虆	sjjb
葓	sist
矐	mdwi
掝	aglf
甖	mmaw
卄	sjjj
堽	hmfn
稝	rwwy
鳶	groy
穅	ruxk
鷽	rwwr
娏	cdto
蹢	noud
摍	aoej
躈	neoe
甋	ouka
賁	dsmb
菎	sjrr
惏	yffv
輒	gaxi
蕣	seya
鶻	mrog
愭	yhrj
紿	bvlv
恅	yhri
綃	bmwy
鸒	rskr
噣	lmwk
檸	foya
冾	syei
薺	sous
罙	ytfv
貽	mvlv
鸤	byah
嘄	lrfv
蓽	sjsa
櫽	ceff
婰	ckst
嚃	lmkp
鬂	heft
撀	hbqt
鞜	gkjr
摡	axvq
籲	qylm
跜	nbri
臶	hsnv
喍	lnrf
睼	mjfn
鸃	ruqg
厱	srlh
歍	yeiw
賍	muht
轡	bgbl
矯	qell
齵	mkyc
飶	yyqp
齢	npxb
繸	budp
齻	mdmt
摑	angf
萵	snaj
垺	hevk
憱	yomd
訃	umoa
塉	hssw
妠	ckte
誣	uftt
璯	gtfj
荺	shws
鷋	stfr
縕	bntm
壗	hxfm
饅	yjmb
藛	soru
帋	tamv
栞	hhfv
髶	hara
妀	bcnj
埱	hkmb
掗	afja
繏	bcct
薵	shva
挴	aqbm
髤	hfva
魷	tdoy
唋	ltff
夘	rxjk
醔	rugo
憻	yonf
愷	yjfu
幮	muha
愓	yjft
贐	mxfm
鞙	glwy
囪	rtod
娞	cecn
徤	rxax
鴱	swro
黵	nysu
踒	nrcn
盽	mdnf
輚	gggg
褱	omkr
銼	wtth
踴	nbtx
擷	ahlm
屓	bmbh
瀒	idfl
憼	swly
眑	mvxk
鞌	ocge
紁	bbod
鞹	govc
盋	sbom
欱	yeie
囥	noqj
駌	rvdm
貸	egmb
圗	nvds
翭	xxeq
墌	husu
怇	ygbu
鵖	xvro
扗	ahto
恈	yvwn
啳	lugv
淟	ikst
拲	sttu
酨	dggo
瞂	edmo
硾	desj
浀	iksj
犃	wilv
痁	pmlv
攓	aosn
譙	uwuo
櫋	ftpo
蔎	suqh
猤	rbfg
拕	aori
硽	dgkd
磎	devg
豯	devg
僸	effh
詒	uvlv
杤	ffwy
傎	edmt
髱	hwck
錑	wisq
垉	hwck
巁	jssk
鐋	wijt
屪	bogm
峏	jsrs
袨	povo
壾	hlub
賳	mdgl
貭	edmb
湦	ijwg
鵻	rwio
晑	jrnr
睵	mdgl
儊	effn
譖	ugqj
卪	xodj
迯	rmpd
狊	msqf
攐	aosr
狥	rwjr
渒	iwdi
蠭	edpk
葍	sflj
徦	rbsb
縖	bodl
藾	sflm
倛	edje
牅	xuxw
螉	ktvx
碽	dfmb
炲	uvlv
躟	nolr
鯮	tohs
曅	jshs
囬	nnsi
彜	bpts
熰	ugll
飵	yqmo
銒	whhg
揁	ammb
蟧	kuux
皡	eesd
夞	rmlr
餧	yrcn
嶱	jsjx
錴	whth
龏	iwms
屖	boxh
豜	dfsj
龔	iwmt
蒠	styi
繂	bovd
帊	mcbv
賎	msgg
梌	ftff
梀	fflv
寊	ommb
曄	jshs
翢	whlx
繗	bpra
獧	rmfr
敀	eehb
毨	rwqr
幈	mbus
詏	uvxk
氜	qjrq
鏧	hbqw
倸	eefv
駷	dflv
憣	yqpj
鱣	tonf
鍺	whjr
帠	rmvj
礱	iwmd
曣	jsfu
薠	sudm
蛢	kusj
雃	fswi
銡	whlv
冘	yqrm
銈	whht
菄	sfjr
胿	whht
檜	ftfj
緮	bqje
韽	tovj
濳	iwqj
皬	edwi
屔	efbr
鉝	widj
鸇	onlr
俉	efcl
蛝	kvnc
恦	yrni
灗	ikof
鎃	wier
捖	aofh
夀	hvla
梲	ftlq
毜	rmam
駏	dgbu
柗	ftlv
蝑	kvnw
訽	uwlv
丵	kudi
齰	msjr
蚾	kvpc
濶	ikre
奀	dgdu
螁	kvpd
廱	uvlw
峱	rbjs
浵	iwot
瘧	pmxl
菋	slhe
鷾	ijyr
坲	hvti
彴	rwod
擄	amjx
汘	iwks
揨	aoan
镼	hbxx
綋	bosv
藰	stwm
鋱	wgyi
弚	uvns
価	edxe
桱	ffvf
綩	borv
刢	tobm
踄	nnma
鉣	whvv
恉	yrjr
乆	xtei
朳	ftiv
酼	govq
巏	jslw
粛	xpti
邌	rwqp
腍	wtoy
唜	hlri
幚	dcem
繒	bujj
鉂	wlwl
鱦	tjmy
搘	ahrj
軎	glvc
戓	glvg
滝	iikd
霳	dcew
鬝	hkjr
黶	sjwn
欞	fdlt
棶	fdlv
檟	fdmb
飤	ytes
圠	hxit
嘰	lvvt
炂	utvv
麞	iijd
徖	rohs
齸	mutm
甴	jnsr
洈	iysv
鷗	gllr
廘	uilu
刋	wmdk
櫄	fwne
瀙	iifm
嗈	lvlc
啒	lbxx
骿	musj
咍	lvlv
診	utto
坱	hkgd
稡	rotd
偍	ejfn
宨	oqss
濓	iiqt
嘇	lvvt
塅	hefq
籚	qmjm
浺	iyln
枿	fdsj
侾	ehvk
猄	roma
罸	muac
燇	uuga
籂	qyqm
崺	joqc
驈	dcql
脭	wlgn
圌	njsr
暶	joqn
綸	btfn
喠	lwkk
斪	wlej
饛	ysyd
鬔	hedp
紷	btob
簴	qmkt
顥	jomm
傡	eiid
饜	sjwy
雺	dcqp
荾	svte
旐	oqqs
紾	btto
氊	ronf
緃	bttn
綌	bttl
瀌	iiuo
嚩	lbfa
俧	ehyi
犿	romo
箚	qymd
剱	ytbo
欛	fdgw
喡	lciv
浫	iyth
勹	wyyy
獷	rust
穬	rust
淕	ihth
樳	fxfa
衜	ruta
鎿	wytu
鎼	wmtu
昷	jmnr
爯	ekht
觘	ytmq
柕	fcqp
鬰	fwwt
窐	phht
黷	nhmm
萐	sfxn
瘏	phjr
摦	agfq
凪	qnij
尀	glac
摲	agej
緟	bwkk
惗	ytoy
牑	tinc
錮	wndg
朸	fxkv
堩	hyff
腡	wnay
跊	nhev
蚻	fxkc
縩	bwhs
驑	dagj
捹	agds
諭	utfm
俋	elcb
雫	daky
鲪	qxql
頍	dbdm
欑	fwqm
踋	nhvx
盳	muwf
嗴	luxv
筧	qmxk
縌	buxp
塺	phta
裬	phte
銧	wmhw
旇	oqvp
佒	ekgd
潱	ihyu
萉	swcb
褹	phto
斿	oqvk
齃	tjax
蒦	swbu
籊	qxxw
罏	wmjm
槥	fddx
稸	rovj
粩	phri
鍘	wmmd
襭	phlm
詅	utob
鍞	wmmb
鵲	sjro
嘒	lddx
禠	hemu
劥	oqxk
熗	utol
敺	gllb
誝	utol
欝	fwwa
猐	ruxi
噄	ldbb
槜	fwvj
儥	ehmm
嚹	lwma
襗	pmhd
鰥	tmkv
泇	ixlv
銞	wjwj
圲	hwkt
穖	rvvt
鎅	wjtt
愥	yskg
蚏	kwyc
戁	sfly
杹	feri
騜	degn
麩	degu
裶	pliy
犦	wjsk
喗	lygc
旊	oqaw
睧	mtaj
旚	oqdh
菛	sknj
旜	oqof
櫿	fuul
偭	egie
頡	hldm
欯	hlei
樤	fenf
莣	suyi
蛠	kxxx
樇	fenw
橏	fuul
懜	ysmr
蟉	kxxt
腗	wkaj
掦	ajwt
麳	dedl
麏	ixql
紱	bsbo
襉	pkwy
暣	jqpm
禫	hdjd
襙	pllf
顚	rmxm
噡	lysu
覑	tmxp
爢	pluo
銲	wjhg
擑	alag
塋	uuyh
蚐	kwsi
猭	rbds
晀	jqss
嵤	uuyj
塤	hlmb
伂	efmv
蚼	kwlv
亜	alfi
悪	alfy
鶪	msro
壩	hdgw
斢	sktd
疻	plti
竸	ijqq
萺	sksm
牶	ugwn
妿	xlcn
赾	dejk
畖	jqut
麷	deju
躆	nmds
俌	efue
藀	suuu
莕	sflv
焿	uuxt
輨	gobb
撊	akwy
嵥	jraf
辡	ooxx
皩	egjh
鐦	wkfs
偆	egjr
衇	qmer
塟	sfrh
韹	ijeg
葈	svlf
膥	hdvt
墣	hkug
樔	fvjf
臋	bstt
剨	ddmd
硺	ddod
羙	uuog
槰	fedp
錪	wkst
杛	fvgv
櫍	feem
傸	egww
芓	svkj
嬜	ijec
蔃	svlk
淾	wkvj
磩	ddkm
皟	ehmb
篹	qmgv
摝	ailo
秄	rvkh
譄	uujj
腢	wkyy
旓	oqmw
鮋	tkoy
攟	ainr
灃	ijdu
驔	ddjd
眕	mtto
騏	ddjm
伳	ehie
皢	ehhh
峷	joxs
桗	fvfv
鵔	rvte
漝	ixxe
纒	bskh
濌	wkkj
謶	uusu
琑	gmwy
枛	fekv
嚍	lxfm
頋	svdm
謚	uutm
庒	uhod
濢	ixxd
粙	pkom
鉀	wkjj
乚	xii
澲	ikut
譶	uuua
旼	jpwr
抇	ajro
猻	rvqb
誁	uusj
揋	ajgf
牰	wkon
闟	kyxx
賶	mtol
謮	uhmb
豶	ddsm
蕳	skjr
囦	nkvw
丂	skk
衂	qmbo
暽	jpra
葘	svfj
疄	jpra
襇	pkjr
贑	ijfm
郆	hlcj
珘	gqon
韰	mrbf
撯	aumf
碅	dnrh
篟	qehw
蠵	kjwl
紌	bdos
笩	qegy
畓	kjtv
厳	isve
荗	sdod
盠	bdmn
礈	dudp
疿	pvti
湙	ipgd
樃	foxw
餛	yjrr
蜫	kjrr
洃	isuo
鞿	gvvt
趥	dugo
淧	ioyq
洂	ipis
捝	aulq
蔩	soft
絍	been
黋	mhst
駢	dusj
搼	augt
亱	oejf
絤	bdxs
萗	sohs
彨	fkkt
梩	fkkv
浶	iown
樐	fklv
乣	vxio
駾	dulq
笿	qelv
凴	sdqj
靤	gwck
彃	vjsa
軝	gtai
艼	sanj
梬	fksk
亀	yjkd
贚	miwm
蜧	kisq
硲	dttl
榟	foox
孨	vvvk
鴺	gvro
畳	jymi
籗	qdwi
巋	jynm
夰	gtid
詉	ucbu
玐	gtin
趖	dtth
叄	vvvf
尶	hsqm
豴	doud
湥	ipsq
坄	hqht
蝹	kjmn
揃	auwm
梈	fovl
萖	srqr
莵	srqo
槒	fovj
顋	jydm
瞕	mijd
覭	yjom
蠝	kjjj
鯳	tuto
髸	hsti
塂	hstc
驤	dolr
鱔	tuul
耛	dtvl
虁	sdme
匬	gtfm
挮	auvq
鱻	ttty
曺	fkjr
捬	auea
悜	ylgn
馺	dvod
砐	dvod
捈	atff
罆	wbdm
覲	gsmx
岉	jwto
戣	bfgg
焼	udsh
磆	dmgh
彄	vgll
襒	pume
閴	kmbn
髐	mhhh
鷪	mmyr
絊	bffi
錣	wbbb
専	fkac
韈	gsmo
駊	dvpm
瑹	gstf
匫	gwtj
幗	mngf
胟	wbmy
臦	sscc
齫	mnfv
墑	houd
豂	ttlt
湸	ioqj
賚	dmbl
絿	bfko
墎	hovc
匢	gwto
顨	dmda
馻	dvqr
綆	bfjw
槯	fjwi
瓰	atbd
钃	wbkk
蓷	sawi
篐	qfgm
萅	saxj
惖	jwty
磄	duxl
蛧	kkww
鸝	fkfr
繑	bell
沝	kkvv
纀	bekg
礠	duvy
聬	atvx
滀	iovj
憰	ycql
蝐	kksm
琻	gwjn
燂	udjd
掱	tttu
皹	vygc
闁	kknn
煛	mmuo
聄	atto
槷	hthf
愇	ycii
猟	riqa
帾	mhjr
嶕	jwuo
嶣	jwuo
綬	beyb
炐	udno
趈	dmlv
挩	atlq
靮	gwod
鸜	mmwr
閭	kllv
胢	walv
迀	hpdg
酈	fkfc
裧	puuo
璓	gsrv
闠	klkm
竆	pwll
壏	hsqm
渃	issl
饎	yhll
褌	pygc
曫	ubbj
囘	kckf
澕	ishs
蜙	kftv
濭	ishm
蝚	kcqf
扚	awod
鷴	kfro
襐	pyld
萕	spts
眒	mkef
耈	hrwl
藦	sptu
盙	fmnu
礇	drpg
簈	qbqh
鵕	vter
勄	qbxk
懎	yhtl
稶	rglt
撳	awei
臠	ubbt
鯓	twmy
摋	awfq
睗	mjwt
藞	sddd
葽	sdcn
舥	qcbo
珶	guvq
擕	awkf
揰	awkk
蟤	kcct
颿	drfm
憉	yhlt
蹨	nwsu
牎	twty
涹	ircn
矂	mllf
緐	qbqb
梠	fllv
砈	dsvi
撏	axfa
蒘	sclt
趦	dsel
堄	hrqr
徢	rfxn
賟	mkst
盬	sqdm
耴	axir
饇	ygll
蠁	vqok
忕	ygdi
潻	irtk
愅	ygei
鰞	tywy
鼖	dshb
魫	tyqr
趞	dsjr
扏	ayfo
謌	uall
鵣	flro
蛷	kfko
訰	uaxg
欔	fmmb
绬	vskg
蔯	scfj
獑	rgej
藭	spwv
槕	fmjf
誀	uara
喸	flri
鱾	qbjy
庁	uanu
幑	rfmv
籒	qaaj
悏	ygtt
礪	dssk
蝢	kdmb
荈	srao
敪	bbbe
壥	hsnh
靷	gvns
洏	isrs
萫	srjr
礳	dpdh
懚	yefy
闥	khup
蚲	khue
徍	rhht
坔	khtv
飮	yeis
悷	yisq
洬	iqfr
蛯	khri
廃	ubsq
珆	gvlv
恵	fkyi
灠	isqm
摾	avlk
焏	vlbu
瓵	vlaw
蚭	kbri
懯	foey
汑	iqai
鞁	gvpe
秷	rhkh
餳	yjft
氹	vkvi
髗	mmjm
挅	avfv
峗	jysv
閕	khyn
峞	jysv
惿	yjfn
矑	mmjm
耉	hslv
椗	fofn
琀	gtol
瑲	gtol
藒	srjx
竌	iqjd
砱	dtob
漡	iqjt
頼	fldm
簛	qdej
蛺	kgtt
篲	qddx
蒶	sbtb
払	avvo
耟	dtgb
潕	iqsu
覂	dqpe
聨	avvs
畐	fljt
懓	yeye
樖	yfal
炄	ubco
蓗	srdk
蘶	srcw
灡	isku
閹	kgkd
蕸	sbsp
慀	yevg
蜛	kbdg
郟	gttc
憿	yeoe
竬	iqkk
訒	ubod
拫	avno
揟	avnw
扱	avod
曱	khgf
幜	mjom
壒	hshm
璅	gvjf
搎	avqb
宻	obuj
忩	tvyi
煝	ubmf
砓	dqhh
藢	srfg
釼	wbod
浛	itol
冞	ypmm
畒	ojte
杁	fruv
鏿	wnfv
癓	prfq
尦	tqwo
戹	ivie
愘	yoel
鯘	trcn
榡	fhbs
釪	wfau
繟	blld
殠	frts
諢	uygc
泀	ivfl
靏	dywr
霘	dikl
瞖	gqqm
騼	dilm
覝	humx
輈	gqoc
黳	gqqn
祡	nrhs
訹	ufod
圷	hakt
矹	dhwh
伅	eaxg
茪	smhw
橑	fgum
蹞	nrdm
翲	dhxx
詡	uxxi
蟩	ksue
尣	tqri
灻	huot
歿	frwb
翷	prax
熁	uxxw
镸	haaa
薈	stfj
脡	wexn
瑿	gqqo
瀤	iomr
癁	prqe
澞	imlg
潁	rkdm
梐	frrh
諌	ufjr
髾	hmwy
趂	dyma
綗	bktl
繷	bkss
鱮	trst
鴜	nrro
抍	aqsj
枺	fhov
颸	rjyi
謺	hudu
趧	djfn
齼	mffn
艓	qhfv
磓	dypd
琁	gqvn
鷖	gqqr
黿	fhjm
霔	diog
彵	rcyc
欅	frst
秱	rkfl
盿	mpwf
楪	fhfv
麛	ivar
渳	ivar
湵	iuyo
霟	dist
蜹	kskt
鑠	wevf
尯	dysv
醓	gyqm
璑	gqsu
簀	qhmb
鉖	wesi
垪	husj
攡	apxw
飁	xxer
幩	mdsm
叏	bnbu
螿	xwak
絸	bmxs
駆	dgwl
黌	rwwt
樠	fsfr
懧	yoya
蒪	sfac
訆	uxga
杗	ufvw
皅	ecbb
沗	fgkv
螥	ktol
艑	qinc
鈢	wfvj
乿	ebxi
禒	hbds
槳	xwaf
僪	ecql
舏	rxge
硤	dgtt
傤	edgh
燾	hvfu
悋	yplv
僉	rll
壆	rwwh
揥	aoum
菍	stoy
黣	nqbm
珳	gpto
厑	slri
謈	jstu
檶	fggl
徎	rlgn
泑	ivxk
錛	wgds
洠	ivwn
珻	gqbm
繉	bmqs
歅	dhei
葠	sexb
溳	ilmb
砞	dhoh
覶	ebkm
熽	uxtf
泿	ivns
壣	havx
酘	gqho
欪	xxei
橬	fgqj
嵲	jtfv
棅	frxl
峑	jtgn
芿	sevj
鹒	uxty
籺	pqvi
彯	dhto
鋀	wflu
骪	mqod
磧	dhmb
恔	yotw
栕	fscv
篰	qilc
崏	jtaj
潬	illd
懠	yous
驍	dhhh
丆	dhhh
侭	ebos
簜	qijt
攨	apqq
畟	jteh
闑	ktfv
墿	hmhd
虣	fgnm
疺	pqpe
尩	tqgn
趌	dhlv
蓧	senf
碭	djft
劚	bkmm
劦	xxxk
縤	bhbs
魵	ttbd
蓸	ssjj
殀	freo
戉	gxig
遖	dkup
萚	saba
鏏	wddx
歽	frej
蚢	koqj
蟺	konf
仌	ttee
鮽	ttff
菆	sabu
殑	frdq
翆	xxyd
翬	xxyg
茩	sefl
氫	qfvf
浂	iugd
蠐	kous
甞	nssi
峅	jvsj
磵	dkjr
懅	ymds
鶣	inro
昲	jvti
魒	wdhs
騣	dwxe
埞	hofn
浉	iufm
柦	fjfi
緖	bhjo
紲	bhis
栥	sefv
絓	bhht
摕	asfm
赬	httm
靎	dwro
肔	wcyy
牏	ttfm
櫑	fjjj
畽	jwkk
蠥	xyok
柹	fqxq
騅	dwim
蟐	knmv
豃	ttle
闣	knjt
埦	horv
湻	iojr
鏺	wbvq
霢	dwer
峼	jwlv
衸	ptti
銯	wbsj
谽	ttll
胒	wbri
龥	yllm
跧	ntgn
赮	httb
卥	mnto
笁	qfok
毚	ylro
椙	fjjr
擫	asjs
殱	frdf
韱	ttgf
擖	asjx
罭	mglf
蝏	koan
孲	vfja
釹	wcnj
醼	gsfu
彮	ptlt
滖	iofr
浨	iofv
毢	rdxm
抪	asmv
黚	nssi
穽	psti
斸	bkme
緭	bjwy
趉	dxxg
騽	dxxe
賥	motd
繀	bjwi
脟	weac
髖	moso
蟂	krfv
噟	uewl
殬	frmd
縵	bjmb
睘	mflr
垿	hucu
趩	djst
瘄	psjr
涀	imxs
濎	imxt
貜	ymmb
淲	imus
鍭	webq
鴇	rdro
眪	mfkt
槸	fhto
鷙	hudr
亴	ohyf
瀠	iuub
饏	vaey
砕	dydi
怣	qgyi
劮	qgxk
蜏	krvj
宯	ohvk
缿	wefl
劽	frmx
湨	imsq
薡	smxt
磟	dxxt
脮	wecn
仒	tsie
繓	bjab
掜	arqr
聣	arqr
甛	ssre
卙	dxdi
餶	ymgs
乹	djxi
殰	frhm
殜	frhf
厰	sneh
緈	bhud
閔	kpwn
譤	ueoe
澁	innn
殣	frgs
轚	gxqg
萲	sehb
樏	fjbs
朞	dwyj
曏	jvqc
戞	dwyg
椼	fria
糮	psqm
罊	gxqw
箺	qgjr
槴	filc
拸	arrk
翏	xxtt
肬	wdoy
潶	ines
筪	qgkj
劯	dxkh
磪	djwi
歁	dxei
呄	vdgj
鮞	tsry
羋	snao
卂	vdii
袸	psnv
筺	qggo
楌	fiqt
圸	hjst
矒	msmm
踲	nedm
餾	ytjt
禰	hftw
疇	jhva
舝	cvya
蘁	sgll
轗	gdfy
飴	yvlv
鐥	wuul
儣	eust
噒	lpra
釳	wqvi
啂	levx
秪	rtao
頪	pdmb
鯟	tfjr
愾	yqpm
斣	mwkd
繲	bytw
鈄	wsdi
蓲	sgll
妱	cblv
襏	pbvq
鎬	wolj
譺	urqn
觓	ytxg
岏	jfhw
嚤	lptu
瀀	idwe
侚	ewjr
夿	gcbd
晵	iejr
暿	jhll
狧	rreq
揻	adfc
軲	gdgc
鄟	gacj
湢	iflj
蔳	sihw
溨	idgf
昛	jgbu
唙	lruo
甽	jqct
畧	jelv
漌	igsi
媝	rucn
幤	nemv
瑃	ggjr
鹼	krll
焢	upfo
呩	lhsv
魤	teri
暷	jgac
箤	qotd
塐	hhbs
獘	umts
慏	yyjt
謻	urrr
鶱	ostr
溹	idyb
惾	ywxe
晍	jkfl
仯	emqp
鈖	wtbd
獀	rrnb
蝸	knac
渀	igds
侖	tfnc
裲	pfmr
鵆	rrah
嶗	juux
懍	yonr
喐	lswc
煷	uoqj
埊	jkht
乕	esmv
膁	wuxt
鈰	womv
跿	ndkv
焎	aeuo
闈	kcin
釃	gfki
閏	kgnn
珱	gicn
藎	sxfm
躻	wpfo
櫛	fqxx
愯	ywbu
侅	eoie
鍑	wqje
粸	pdjm
呮	llti
鑙	wrdj
厫	shwe
鉒	wogn
奩	ggll
鞱	gerj
袹	pdjr
韃	ghup
袙	peby
姺	cwqr
嚽	lhwm
炞	uomo
靾	ghie
奲	ghjd
袔	palv
軽	gbht
鉋	wwck
浳	igwy
婖	cfgo
楃	fbhk
鷭	qpjr
銛	wrej
埆	hytn
峘	jfjf
醏	ghjr
鎒	wsac
瀦	idhj
焒	ullv
錠	wofn
遻	llup
臎	wxxd
錀	wtfn
瀡	icsp
鈆	wtvv
籞	qrqh
膉	wutm
戻	igde
夈	epmh
睭	mwhl
阧	csdi
籯	qumb
煰	ulll
艅	qtff
岊	cjsb
錍	wwdi
侊	emhw
乸	cbmy
婤	cwhl
壙	hust
甒	qsfa
鈸	wsbo
惲	yygc
儩	emjt
踈	nflv
佡	etjs
賙	mwhl
偢	eruo
琺	gihv
鄒	wxwc
觙	ytvo
愗	cqey
喺	leqb
鏌	wsjg
楘	cqef
姅	cuao
醞	gntm
嫮	cdfs
涊	iboy
鶚	llfr
貹	mwgb
喩	lrfv
蟇	sjgk
軑	ggdc
擧	rskt
譠	uonf
緪	byff
撆	umtt
謁	ujwx
臏	wofm
鎊	wouo
棷	fabu
萿	sire
鳰	rrou
鸻	raya
鍗	woum
羳	uqpj
軭	gggn
魺	talv
螌	qqkc
錚	wyxv
嬟	cuqg
訷	ukea
鳧	rqjo
颶	rmti
鯻	tflm
軂	wuux
撟	aell
伌	esvi
聧	abfg
熂	uqpm
彸	rtvv
阸	civi
溌	ibsq
熿	uskt
諍	uyxv
臇	wwkf
漚	igll
銉	wxao
褄	pdxc
嘕	lfnu
檉	falg
鏑	woud
簫	qxtf
鏨	gewj
韝	cskh
鋩	wsuw
烻	uqnx
婍	cgal
暒	jjwg
槑	lflf
揇	adkd
藺	skwi
銃	wovq
庿	usjt
鎂	wugd
壱	hyri
窛	pfhc
惤	yvov
嶐	jcew
笶	qqik
僿	eosh
嗊	lfmb
蔛	sytd
仐	tdie
嘳	llkm
翶	essx
揼	adkv
鎡	wuvv
陙	csnj
忣	yvod
噧	lsky
婻	cdkd
鱤	tdfy
腝	wsgd
蘙	sgqx
膰	wqpj
篖	quxl
摵	adkm
銭	wsgg
蘚	stug
偹	enej
攱	idbu
廡	uqsu
踁	nfvf
蕼	shxa
铻	tfcl
臙	wsfu
隌	cijr
蔂	sjbs
薝	sysu
嬚	cuut
焫	uskt
瓉	gggm
襖	prpg
敯	cajb
峛	jfrm
鄐	ovjc
娔	cdqr
鍂	wwjj
翤	lnxx
芶	swvv
黰	ndmt
諛	urte
婐	cjfv
墪	oveh
幐	wugm
爮	ewck
狿	rqnx
誹	ulia
糓	hfpm
鈾	wkoj
瓧	adiw
囸	nfni
籝	qucn
惥	rtyi
摜	abdm
歒	ouke
琹	ggfv
懻	yurt
窴	pdmt
袌	owcr
蓡	sixb
曨	jiwm
巄	jiwm
弿	ostv
忷	ywxg
舤	qqod
鏇	woqn
竼	qqod
啇	oukd
鷨	shsr
鎢	wywj
顕	jkdm
肎	ywym
叿	lfov
爤	usku
琖	gggg
鋐	wosv
俤	euvq
脺	wotd
圇	ntfn
嚸	lnml
隟	cvjf
鉻	welv
浲	iedn
廀	uoub
跥	nvfv
玅	ovmq
寜	oymv
顦	wudm
琒	gedn
躀	nbdm
囕	lsqm
葋	swwl
艖	qufo
懬	usky
竮	ibus
熈	qscu
韒	cmwy
窉	pfkt
埾	abht
婸	cjft
鞖	gecn
賑	msnb
覟	hymx
傗	eovj
齦	mvnc
躊	nhva
燁	ushs
贍	mysu
侰	exql
娧	culq
躥	nprb
垼	rqht
譲	uotr
瑫	gerj
恱	ytvq
姈	ctob
唓	lgcv
脗	wwtl
佌	enri
謥	urey
慁	ndyi
綔	gfsb
籹	pcnm
緇	bvjt
紼	bvti
詋	ulqr
氁	rsjg
軯	ghue
郔	qnxc
熚	ujsa
甀	esaw
痷	pgkd
韗	cygc
釚	wyfj
皉	enri
蔰	silc
岆	jeos
嬹	crkt
惸	ywjv
跠	ngvg
暙	jgjr
灹	uqai
噮	lmfr
詣	urjr
挳	afvf
縟	bsac
呏	lqsj
鈊	wyij
呝	livi
鎻	wvmb
洦	idjr
蓱	sius
鷍	tfro
郀	gfsc
胇	wvti
賐	mvte
脷	wrmd
訿	unri
滫	ienw
繣	bxhf
錹	wnwy
跒	nalv
吺	lqhv
罋	ovqw
銫	wycb
憏	ywhs
渿	ifhs
儐	eofm
媱	cewo
嬀	ceww
岶	jebs
襫	pgdj
昁	jfmv
觗	ytta
葷	sygc
枠	fydi
澦	icdm
竱	igac
阾	ctob
蘜	sgwp
黬	ndfl
椵	fbsb
筣	qrmd
梫	fxyb
皼	hyfv
嬇	clkm
敤	jfmb
斊	parw
偤	eugo
嵓	jlll
鐣	wntu
嘑	lmqa
傇	esar
偄	esgd
鏼	wqfk
卌	sjjj
嬔	cylw
韔	chai
轐	gkug
洷	ihks
黓	ngye
鱆	tijd
灢	idlr
鐌	wyld
陒	cysv
乵	oxix
褑	pehb
瓲	aaxg
艌	qtoy
剗	ggmd
啘	lorv
媃	ccqf
瘈	pdbg
轛	gkua
脕	wylq
紉	bbod
曤	jdwi
鞽	gell
脪	wwsm
瑔	gekv
肣	wtov
隃	ctfm
偛	ewrj
哤	ldto
鉨	wyma
暭	jesd
嫆	cptl
飇	rsss
敽	elkb
滼	iffo
伨	ewsi
颻	ewrf
軰	urgc
孊	cpli
譭	urfq
絑	bwti
佊	evpe
钄	wsku
嫟	cgsl
骩	myfg
羜	uoan
瑵	gbok
躓	neem
悎	ywlv
傟	etvx
儹	ewqm
婂	cemv
伀	etvv
粏	pgod
韇	ghmm
嘙	livc
轖	ghtl
峹	tffj
鎭	wrmt
唈	llcb
颴	rqvn
鄽	uktc
嚡	lghh
噳	lmlg
繮	bfjf
綾	bhte
軚	ggod
橚	fxtf
熅	untm
衼	pdbu
賛	ggmb
綰	bobb
儳	eylo
嬺	cgsy
妏	cpwn
兺	tblr
聑	aarr
僠	eqpj
氎	jjjr
恊	yxxx
裦	otfr
呹	lqgu
媂	coum
皍	erxj
氋	syfr
龞	umtj
稬	rsgd
諉	urcn
釨	wvkj
鐖	wvvt
阞	cxkj
詼	usuo
嶯	jlag
旕	otsr
踾	nflj
爎	uogm
昦	jgti
犗	wodl
乻	otsv
陊	crrk
帤	clmv
曶	wtjr
鍍	wusb
鞀	gblv
隮	cous
屶	jbds
攺	cehk
嚟	lrwk
鍈	wskg
鴣	drog
鶂	rqro
臿	wrjk
峺	jfjw
崋	jhsj
蘠	sxhl
洔	ihac
鑗	wrwk
娪	cfcl
嬏	cqpj
乑	etsi
旣	ergq
嚊	ltja
鲏	qvpy
嶎	jbha
絀	bxxg
讜	unne
傮	esjj
弅	tbsj
湶	iekv
娬	cfgn
笅	qwwl
扡	acyo
櫝	fhmm
彾	rtob
蔁	sijd
檘	fblo
顎	llfm
豙	idsd
侻	eulq
嘺	lell
亼	tfie
嚺	lmup
謖	ujte
僒	epxl
拰	aeen
儔	ehva
螜	hfkc
鎞	wrwr
洓	ifkf
孈	cjwl
嬡	ceye
暁	jdsh
黫	ndht
阰	crri
陼	chjr
騾	djbs
醱	gbvq
墝	hhhh
贂	mvvt
鍧	wwua
驪	dfki
粔	pgbu
伿	elti
曘	jdsr
嚙	lmcv
忦	ytti
摓	aedp
揗	aedm
蹥	ngpd
嫐	cjxc
蕍	sitm
亐	sxii
佮	eyee
薍	sebx
乥	quvi
簩	quux
荿	sdvi
乧	sdvi
蘾	shor
狛	rebq
蘎	sdwc
苩	sebj
秹	reen
苮	sejs
顩	rdmb
頢	rdmb
獿	rdme
鷌	rdmo
獁	rdmq
敐	sehn
徝	rdmi
葲	sekv
厵	semm
徱	rdhs
秙	rdgh
藵	selr
茽	seln
荎	shkj
稘	rdjh
猉	rdjq
嵆	rdjs
諬	rdua
凲	quxt
茊	sefi
葮	sefq
狵	rdto
鳒	quxt
莑	sedn
徆	rdxc
衚	rdwa
獶	rdwe
憄	rdmy
攷	sehk
賾	shmb
穤	rdsr
茠	sefv
葟	segn
蔶	shmb
獖	rdsm
蔧	sddx
稏	rfja
薘	shup
藄	sdbs
稉	rfjw
乯	quav
蓻	shuo
藸	sdhj
薽	sdha
蓩	scqx
鶜	scqr
蒢	sctf
徰	rfnn
徚	rfnu
颲	rfrm
獺	rflm
稫	rflj
犻	rfmv
鷈	remu
狅	renq
鴼	relv
穱	rema
虂	sdnl
蒖	sdmt
蓫	sdpd
獥	reoe
艔	qusb
慿	sdsy
獢	rell
穚	rell
蕶	sdtb
艤	quqg
厧	sdmt
凐	sdht
蔈	sdhs
悤	reyi
乊	quep
蘦	sdll
箞	qugv
獔	resd
鴤	resi
蕔	shub
蕆	sdmb
䲡	qugo
鴚	ralv
萰	sfnu
鴴	raro
飅	ragj
篧	qywi
笉	qwsi
薚	sfrt
茢	sfrm
狾	raej
蒆	sfqc
虉	sflr
鷰	sflr
蒚	sfln
茙	sgso
臡	sflt
囏	sfll
箽	qwkk
顈	rbdm
劎	rbdl
瓝	qwod
艁	qwlv
鼦	rbbl
藮	sfwu
鳛	qxxe
蠞	qxvk
葝	sfvx
遀	sfwp
毻	sfwr
笜	qxxg
菚	sggg
厙	sgch
蓜	sgbj
莗	sgcj
竻	qxkk
芖	sgdj
菶	sgao
笖	qxot
慸	sfyy
萙	sfyq
蕐	sfta
笂	qyod
萶	sgjr
茾	sfsj
薞	sfry
芌	sfsk
篒	qysk
炗	sfuo
艬	qylo
艐	qwxe
忥	qyiq
笧	qwwf
蓒	sghg
簲	qwwd
蘨	sewb
徫	rcic
颹	rcif
贋	sewm
讆	rcau
瓾	rcaw
笲	qvsj
稦	rcih
躛	rcln
讏	rclu
邜	rcjk
鄥	rcjo
乲	sevi
蒵	sevg
躗	rcan
籪	qvve
鼪	rbwg
笰	qvti
茥	shht
刉	qvmd
菦	sepd
秓	rdbu
蓞	serj
秶	serh
駂	rddm
薂	seoe
秠	rdfi
厜	sesj
芢	sesi
芉	shgj
菙	sesj
厈	shgh
犩	rcww
蒊	serr
籛	qwgg
蓛	sfke
莄	sfjw
莿	sfkm
莍	sfko
鼳	rbms
荁	sfjf
徲	rbkw
鼺	rbjj
箰	qwjv
嬊	sflc
簓	qwht
酀	sflc
萇	shaj
猳	rbsb
秜	rbri
鼥	rbso
颾	rbok
蘻	sgxb
笣	qwck
荰	sfht
劔	rbod
箄	qwdi
厯	sffs
篗	qwbu
藲	sfgl
鼧	rbor
稺	rbox
芅	sgyj
鍫	ruwj
稵	ruvv
穧	rous
鷻	rove
獤	rove
勶	rovx
颷	ruuo
鴕	rori
頺	rvdm
獼	rvfw
秺	roqa
悐	ruyi
獇	ruxv
穣	rotr
饻	rory
衟	rvda
妴	rvcn
稥	rujr
糴	rpxw
秚	ruao
徾	ruai
郳	rqcj
狏	rqcy
嶴	rpgj
鶖	ruro
獜	rpra
穃	rptl
蝵	rukc
獙	rume
毩	rpmm
毇	rpqh
稒	rndg
狕	rvxk
鷆	rmxr
猈	rwdi
悡	rmyi
颮	rwck
鄋	rnbc
遚	rnbp
狦	rnfi
稇	rnfv
秵	rngd
穇	rvvt
覒	rmxm
毥	rwjr
猚	rwiq
秊	rwkh
忂	rmmw
秊	rwkh
穕	rwfv
颵	rmwy
徟	rwhl
夝	rwgk
徃	rwgc
鋫	rmwj
穦	rofm
秮	rvlv
獱	rofm
猔	rohs
稤	roma
夗	rvik
毶	rvgt
䅟	rvgt
忀	rolr
匘	rvrw
稄	rvte
秛	rvph
彶	rvod
稰	rvnw
毞	rrrm
秐	rsvv
舃	rsuo
郺	rrvc
穥	rrst
飍	rrrf
鴰	rroe
穒	rroh
秂	rteh
秎	rtbd
鶃	rrqr
鸌	rswb
舙	rrre
粊	rrpm
秡	rsbo
颰	rsbo
斘	rsdi
轝	rskg
稓	rsjr
玂	rsle
翗	rrxx
穁	rsar
獡	rrwu
卶	rrxj
狣	rqss
獋	rtsd
斞	rtsd
衑	rtoa
毝	rtom
獊	rtol
鳬	rqjo
龝	rqjm
穞	rqjr
稪	rqje
熧	rttu
秝	rrhh
夡	rrhl
氌	rtjr
穭	rtjr
枈	rrfv
毺	rtfm
獫	rrlq
徻	rtfj
獪	rtfj
稐	rtfn
勓	rrex
秳	rreh
藧	sbeb
蒃	sbds
硻	sbdh
蘕	sbep
葤	sbac
稖	rilv
猀	rimq
蒓	sbax
狫	rhri
狋	rhsq
蜸	sbkc
葒	sbfo
獓	rhwe
蘰	sbjb
穡	rhtl
藯	sbhy
蘵	saig
菗	sako
蘀	samd
馟	rjev
狚	rjfi
荴	sagu
蓵	safn
馢	rjgg
馣	rjgk
莏	samq
猏	riwy
菢	sawc
徿	riwm
穝	rjab
稨	rinc
穮	riuo
葀	sare
馜	rjbr
萔	sabl
蕷	scdm
蘟	scey
媐	sccn
葌	sccc
狇	rfvq
獮	rftw
穪	rftw
鰴	rfty
秿	rfuh
衐	rgba
藬	sclm
巸	sckc
徛	rgal
獟	rhhh
徺	rhhh
穘	rhhh
苨	sbri
頴	rhdm
荵	sboy
葿	sbmf
徣	rsjr
穯	rhll
芆	sbod
臤	sbuc
掔	sbtu
鋻	sbwj
蕟	sbvq
孯	sbvk
蓪	sbtp
荱	sbrm
秲	rhac
颫	rguf
飉	rgum
嚳	rwwl
毴	rlim
猅	rliq
嶨	rwwj
穛	rwuo
狆	rlns
斆	rwwe
觷	rwwt
鱟	rwwt
顖	rwym
猠	rkst
恖	rwyi
秞	rkoh
燢	rwwu
雤	rwww
猣	rwxe
獛	rkug
穙	rkug
獹	rmjm
穳	rwqm
睝	rwqm
剓	rwqb
犳	rwod
惒	rlyi
鯬	rwqt
玀	rmbw
馛	rjso
犱	ryod
鴲	rjro
猑	rjrr
穐	ryjk
馦	rjut
馚	rjtb
穓	rjst
屳	rjsu
馠	rjtl
猽	ryjt
獌	rjmb
馫	rjrj
馧	rjjm
馤	rjjx
舚	rysu
馪	rjom
狪	rkfl
穊	rxvq
鳨	rxko
鵦	rxkv
臖	rkfw
稩	rjwy
忁	rjxk
鶳	ryfm
舓	rjwt
秴	ryeh
毸	rjyi
籩	qtpp
斾	oqmv
覾	oqpm
膐	oqrt
旟	oqrt
鴧	oqro
旍	oqtb
斻	oqqj
寙	oqqu
宂	oqjb
辬	opox
宩	opmb
旈	oovq
頏	oqdm
䜩	osfu
惌	orvy
襃	otfr
褏	otfr
褎	otfr
宑	osti
騫	ostd
寋	ostv
椉	oraf
旞	oqup
寲	orqn
迱	orpd
鶮	orol
鴋	orog
袲	orrr
稁	orhl
宐	orfi
宒	ormb
髚	ooqj
亯	ojrl
髜	ojqs
畗	ojtl
寷	ojdu
亰	ojma
裏	okry
畆	ojvv
寭	ogyi
寚	ogwo
迬	ogpd
殶	ogqh
寴	oifm
旘	oijg
寈	ohwy
鶎	ohro
鶁	omro
宔	oogn
谉	ooke
氷	okvd
宺	olaq
寠	oldc
宲	olfv
蹵	omdn
賌	ombi
窱	penf
窷	patm
褬	pbbf
窡	pbbb
疜	pakb
疛	pacb
粈	pbcm
糏	pbmw
痆	pbri
糔	pbok
粎	pbod
籾	pbod
瘺	pbdy
褖	pbds
勆	oxvx
剆	oxvm
塱	oxvh
黀	pabu
襵	paaa
寍	oymn
痝	pdto
黂	pdsm
糂	pdxi
瘎	pdxi
瘨	pdmt
袶	peao
疦	pbte
褼	pdgc
粨	pdjr
籵	pdim
欴	oxve
齍	ounm
郎	ovcj
鶙	ouyr
覫	ouym
斺	otti
叜	oubu
䴔	otwy
虠	otwm
頝	otwm
撉	ovet
鐜	ovew
郒	oxvc
寣	oxua
寱	oxtf
旔	oxax
寎	oxft
旀	ovma
袬	ovlr
逳	ovwp
黸	nmjm
圐	nmog
歮	nnni
踃	nmwy
歨	nnfi
踻	nnav
躢	nkjx
蹕	njsa
圚	nlkm
蹪	nlkm
躌	nqsa
姕	nrcn
凣	nqjs
鬮	nqjm
歬	nqoi
蹝	nrnn
跢	nrrk
啙	nrll
歶	nrky
躋	nous
踇	nqbm
蹸	npra
歄	neia
跭	neao
踸	ndxi
趶	nfau
躒	nevf
圑	nfac
劌	ndfm
囙	nbuw
囻	ncai
顪	ndfm
踎	ndlv
躚	ndgp
蹮	ndgc
跮	nhkv
踜	nhte
踷	nhjr
跇	nhiv
踍	nhvk
圔	nhvm
踥	nicn
蹗	nilv
躎	nftw
歫	ngbu
鬭	ngbe
踕	nfxn
鬪	nfla
旤	ngqr
黖	ngqr
蹖	ngrj
欭	ngei
爴	ngle
髛	obyf
賔	obmb
鶷	odlr
乀	oddd
踭	nyxv
亣	oajd
黭	nysj
黕	nyqr
辪	nyox
悹	obby
戭	ofkg
顮	ofmm
鵍	ofhr
寁	ofxn
顁	ofnm
䜣	oeja
歊	oeil
寪	oeww
宎	oeob
愙	oely
宱	oeqm
囶	ntht
圙	ntgi
朙	ntkw
跉	ntob
鬬	ntbe
趻	ntov
踗	ntoy
蹛	nsfm
頥	nsdm
躤	nsdj
鬦	nsdi
踿	nruo
鈭	nrwj
蹃	nssl
龸	nsss
囲	nsti
歱	nwkk
踓	nwiv
躦	nwqm
躖	nvvf
𧾷	nvvv
囜	nvvw
跲	nyev
蹘	nxxt
跀	nwyv
圕	nxhj
躕	nuha
圁	nuaw
圎	nvmb
囼	nvlv
鬫	nvae
舦	qgod
籉	qhlh
箌	qhmd
筀	qhht
篈	qhha
䲠	qgjr
篫	qfqt
簭	qftl
篢	qfmb
欫	qfne
遾	qftp
簐	qgei
簵	qgel
舿	qgfs
篿	qgac
凩	qfvj
籋	qftw
勧	qfwx
歓	qfwe
氱	qjft
鳂	qjgf
箈	qivl
笵	qivi
箲	qiwq
箟	qjrr
甶	qjtp
屲	qjsp
鳁	qjmn
笌	qhyk
筂	qicy
艢	qhtl
鲓	qhsk
篕	qhvm
舮	qieo
簄	qilc
篊	qist
簅	qiqw
篭	qikd
篞	qijh
簨	qcct
筎	qclv
郍	qcjo
箹	qbwo
箳	qbus
鲬	qbtn
篻	qdhs
籈	qdha
籖	qdgf
簊	qdht
瓥	qdkk
凮	qdjr
啎	qdfl
竾	qcyk
簎	qasj
鵇	qaro
籜	qamd
箉	qalx
鲄	qalv
笴	qalv
籡	qarl
箼	qbhk
篃	qbmf
鳚	qbha
艠	qbfu
慜	qbey
鰵	qbet
瀪	qbek
簯	qfdj
箖	qffv
笗	qesi
筟	qevk
艀	qevk
氞	qfkt
籭	qfki
鲾	qflj
笎	qfhw
氬	qfja
氭	qfjr
凬	qfjr
艊	qemv
筙	qdti
氥	qdxq
艝	qdxl
箶	qdwy
籱	qdww
箂	qdlk
箯	qefw
筗	qeln
簥	qell
筿	qefv
舽	qeao
鲘	qefl
艂	qedn
凢	qqjp
矪	qqoi
鳤	qqob
筕	qrah
鎜	qqwj
籢	qreh
艞	qqqs
舧	qqqo
笟	qquk
艈	qovq
釈	qpbo
簺	qosh
箊	qots
艆	qovn
筤	qovn
艩	qous
艕	qouo
篣	qouo
勫	qpjx
飜	qpjb
舼	qsti
鴵	qssr
艧	qswb
籆	qswb
凨	qsvv
艪	qtjr
笷	qtmk
筨	qtol
䲟	qtfx
筡	qtff
篵	qrtn
籅	qrst
箻	qrxa
鵃	qroo
笓	qrri
篽	qrqx
籎	qrqn
鄦	qsfc
橆	qsff
艜	qsfm
衈	qmar
簣	qlkm
鼅	qljm
簞	qlld
筫	qmbk
笡	qmik
刏	qmdq
籮	qmbw
衃	qmdu
衉	qmel
欰	qmei
𥫗	qkkk
𠂉	qkkk
笚	qkjk
氠	qkeq
簢	qkpw
聟	qlar
箿	qlar
艥	qlag
艛	qldc
籔	qlde
艒	qksm
氝	qkte
笍	qkte
簻	qnpd
鲿	qnsv
簬	qnel
艡	qnjt
筃	qngd
笇	qomo
笐	qoqj
籏	qoqd
箷	qoqc
箮	qoff
笽	qmnk
笘	qmlv
艣	qmjx
簤	qmmb
篎	qmmq
籰	qmmb
笝	qnbu
矲	qmvr
凧	qmvj
衶	plns
癭	pmmc
袩	pmlv
粆	pmqp
糫	pmfr
癏	pmfr
窧	pmjd
袡	pkht
粡	pkfl
螤	pkjt
粴	pkkm
螡	pkkc
痬	pjwt
蚉	pkcw
裃	pkak
瘻	pldc
䙡	plkm
䙌	plkk
痶	pkst
衻	pksi
斔	pkrt
斏	povn
裗	povq
袉	pori
瘯	poqq
粇	poqj
癛	ponr
窔	potw
袕	ppxy
籷	pqai
褣	pptl
裍	pnfv
糛	pnht
癦	pnht
痐	pnlv
襡	pmwk
瘑	pnab
斍	pmxw
痎	poib
糘	pods
痯	pobb
疞	pfsk
襧	pftw
穼	pfvx
瘞	pgth
疘	pfob
竀	pfnm
鵼	pfro
褳	pgpd
瘽	pgsi
糣	pgqj
窢	pglf
裺	pgkd
褗	pgjc
糆	pgim
穻	pfau
衧	pfau
穾	peox
粰	pevk
襋	pfkk
襹	pfki
瘶	pfle
瘷	pfle
裋	pflu
襰	pflm
瘂	pfja
糄	pinc
斒	pinc
襊	pjab
襱	piwm
窏	pifa
粐	piem
褝	pijd
麊	pilm
糡	pijq
窤	pjrr
畨	pjtm
襮	pjsk
糃	pjft
瘍	pjft
裮	pjjr
癳	pjjb
襓	phhh
衦	phgy
褋	phfv
痓	phkb
竈	phjm
竃	phjk
袣	phiy
疶	phib
瘱	pgty
痮	phab
窙	phvk
痚	phvk
疨	phyb
襀	phmb
褤	phlr
窓	pvyi
袎	pvxk
﨎	pwbu
粺	pwdi
窇	pwck
糝	pvvt
襍	pwfv
襸	pwqm
粷	pwpm
裑	pwmy
粅	pwto
袾	pwti
袀	pwsi
袧	pwlv
粁	pwkm
痸	pwkm
褈	pwkk
瘇	pwkk
裞	pulq
痥	pulq
疓	pvjb
糋	puwm
亪	pvii
瘬	pvha
斈	pvkw
梥	pvfv
籸	pvdi
衴	pyqr
疩	pydi
粭	pyem
瘒	pygc
箃	qabu
䦶	pyxv
窹	pxfl
襑	pxfa
袯	pxbo
癄	pwuo
粣	pwwf
糭	pwxe
痭	pwwy
裪	pwwo
瘹	pwwo
粶	pxkv
裷	pugv
袳	prrk
痜	prqj
襷	prst
竁	prrr
襝	prly
鴪	prox
鵉	proi
瘲	prtn
襔	psfr
瘔	psdg
襎	pqpj
袟	pqgu
籶	pqjm
斖	prkm
癪	prhm
癙	prbu
甐	praa
癤	pqxx
斴	prae
亃	prax
裄	prah
彣	ptow
糩	ptfj
襣	ptja
瘜	ptyi
裫	ptxf
褨	pufo
䦷	ptth
疭	ptte
剤	ptsm
衳	ptvv
粀	psod
褿	psjj
襼	pshv
襽	psku
糷	psku
襺	pskk
糎	pskk
褠	pskh
糤	pswe
糚	psxh
衯	ptbd
疷	ptao
痻	ptaj
疧	ptai
糲	pssk
袻	psry
癧	psrn
粠	psti
脵	wlfg
欨	wlei
敂	wleh
鑓	wlkp
鐀	wlkm
頶	wldm
鐗	wkwy
憅	wkxy
軁	wldc
鍓	wlar
鍝	wkyj
鴝	wlro
胑	wlti
鍔	wlls
鋛	wlln
鐰	wllf
躳	wllv
銱	wlmv
膶	wkgn
鉠	wkgd
鑭	wkfu
錔	wkjr
鏀	wklj
鋰	wkkj
鍻	wjwx
鎉	wjxx
鍶	wjyi
鉮	wkej
軆	wksu
罁	wkuj
犅	wkuj
鏷	wkug
鑆	wkua
鍆	wknj
鐬	wndm
鐤	wmxt
鏴	wnel
膕	wngf
銦	wngd
鋧	wmxj
犤	wmvr
鋜	wnvj
罉	wntu
膃	wntm
銨	wocn
鑜	wnmb
牭	wnqr
鏜	wnht
鏛	wnmv
鐹	wnpd
𠂒	wnnn
钂	wnne
鉬	wmfj
臄	wmds
鎠	wmfn
钀	wmfs
釗	wmdj
鑡	wmcj
勂	wlxk
釥	wmaj
鈙	wmbu
鋇	wmbj
釙	wmoj
鋽	wmjd
鑺	wmmw
鏬	wmqa
鐪	wmjx
鑪	wmjm
胋	wmlv
鑴	wjwl
鏸	wgyi
錷	wgxi
鏯	wgww
釴	wgyj
鋣	whcj
躼	wham
鍱	whfv
鐐	wgum
鋏	wgtt
鎱	whlr
鑟	whmm
鎺	whmi
膮	whhh
鉪	whij
朑	whiy
郮	whlc
胵	whky
躸	wgal
釱	wgdj
鑻	wfwt
鏩	wgej
牼	wfvf
錰	wfuo
鑈	wftw
匎	wgkd
躽	wgjc
鏂	wgll
鉕	wglv
鑎	wglm
鑩	wgll
膒	wgll
鉽	wgfo
鐟	wggj
錼	wghs
鍷	wghh
牫	wggn
鑸	wjjh
躶	wjfv
鍡	wjgf
腲	wjgf
釒	wjjj
鑘	wjjj
錩	wjjr
錁	wjfv
鎽	wjed
鉭	wjfi
鎤	wjmh
銠	whri
鍴	wjsr
鍟	wjwg
迿	wjpd
鐛	wjom
銟	wjmv
鎾	wjmn
錌	wjsh
鏎	wjsa
錕	wjrr
鈤	wjrj
鎑	whvm
鋕	whyi
釾	whyj
﨧	whvk
錂	whte
脿	whry
釷	whtj
圱	whtk
軇	whva
鐽	whup
胓	whue
﨨	whud
犥	wiuo
銂	wiqc
䥇	wixx
脳	wiwx
軄	wijg
膱	wijg
鏱	wijd
鍅	wihv
腤	wijr
鐿	wijy
鍽	winc
錇	wilv
犝	wikk
肰	wsqy
鍩	wssl
胹	wsry
鑖	wsmo
錺	wsog
瓻	wsma
銌	wsnv
鋠	wsnj
鈽	wsmv
鈪	wsvi
鏾	wswe
郩	wswc
鑊	wswb
鈜	wsvv
膌	wssw
鐝	wsue
頯	wsdm
鑝	wsep
錵	wser
軅	wsew
懖	wryi
鑦	wsbm
臔	wsbm
鍣	wsbl
鏪	wsjj
臈	wsjx
朠	wskg
鏋	wsfr
鑶	wsgs
鑮	wsia
鏵	wshs
鑉	wshm
鐯	wshj
鐷	wshf
肹	wtsk
甮	wttn
谸	wttl
鋊	wttl
錜	wtoy
鉩	wtma
鈐	wtov
釤	wtoj
鎴	wtyi
鉡	wuao
匃	wtxi
鎓	wtvx
匒	wsye
銽	wtal
躮	wtbd
肦	wtbd
鎝	wsye
銪	wswy
銰	wswl
鎦	wtjt
鑥	wtjr
鼄	wtjm
膾	wtfj
勽	wtey
鎳	wtfv
腀	wtfn
鎋	wodl
肞	wowl
鏲	wovw
錥	wovw
鑏	woya
膟	wovd
鑇	wous
腣	woum
鋶	wovq
鐓	wove
犜	wove
鉉	wovo
躴	wovn
鋃	wovn
鈫	wpwj
鋨	wqag
鑹	wprb
銤	wpmj
鉸	wotw
腟	wohk
錝	wohs
牥	wogn
鏥	woej
鎵	wods
軉	wogm
鈁	wogj
鑌	wofm
鍹	woff
鉈	wori
鋺	worv
鴅	woro
鏃	woqq
銥	wory
鎄	wory
錊	wotd
鑧	woso
臗	woso
鑳	wosn
鍄	woma
鈧	woqj
牨	woqj
鍦	woqc
匂	wriy
敮	wrmb
鐱	wrlj
匇	wrky
釸	wrkj
牬	wqxq
錗	wrcn
躷	wrcn
鋓	wrmd
犐	wrsd
鉹	wrrk
釞	wruj
鏫	wrmf
鎪	wrnb
銄	wrnj
鵭	wroj
鵢	wrom
鉃	wqij
胅	wqgu
鈠	wqhj
釠	wqjj
膓	wqjt
鉇	wqcy
銚	wqss
罀	wqss
酇	wqwc
鈲	wquj
釩	wqod
脠	wqnx
鈼	wqmo
鏭	wqpy
犔	wqpm
鎎	wqpm
﨤	vopd
巤	vnwb
愻	vqby
弴	vovk
婱	vovc
辸	vpdj
叾	vlvl
弲	vlwy
乨	vlxi
貟	vmbv
孭	vmbk
厼	vmav
謽	vlku
辝	vlox
刣	vlmd
𤴔	vnii
彋	vmfr
孾	vmmc
彏	vmmb
鶸	vsvr
弤	vtao
鄪	vtmc
逘	vqpd
鴘	vsro
矤	vqig
鄕	vqec
彉	vskt
弬	vscg
弫	vscg
孠	vflv
弖	vfig
戼	vgfb
弡	vgbu
奙	vgkd
軬	vggc
煭	vfru
瓕	vfto
弳	vfvf
弝	vcbg
夃	vbuj
弞	veig
鳵	vdro
脀	vkfw
乪	vjti
貵	vgmb
䌷	vkos
顄	vkxm
弽	vhfv
疀	vjfn
⺄	viii
𠃌	viii
㔾	viii
乛	viii
鋴	wdqr
銇	wdti
鑐	wdsr
鐼	wdsm
鵯	wdro
顀	wdmb
顉	wdmb
脴	wdlv
鎷	wdmj
犆	wdmi
脜	wdmf
鋖	wecn
鈑	webu
胮	weao
鍎	wedm
銋	ween
鍁	weei
膖	wedp
肧	wduy
鈈	wduj
鍸	wdwy
鉜	weac
鋝	weac
鋍	wdyv
鎍	wdyb
膤	wdxl
錸	wdlj
鍥	wdbg
釶	wcyj
鬾	wdbu
鈘	wdbu
銔	wddi
鍒	wcqf
腬	wcqf
肗	wcny
銣	wclv
釲	wckj
鐁	wdej
銆	wdjr
錤	wdjj
鐔	wdjd
鉐	wdhj
鐳	wdjt
鏚	wdkm
鉟	wdfi
鈷	wdgj
銗	wefl
腖	wfjr
錻	wfgn
錏	wfja
鈨	wfhw
鈵	wfkt
閷	wfkt
脙	wfko
躰	wffi
鉢	wffi
腶	wefq
釫	wfsk
脨	wflv
鎘	wfln
鍢	wflj
腷	wflj
鉦	wfni
脼	wfmr
鐈	well
犞	well
釽	wekj
鈓	wenj
鏅	wenw
鎀	went
肵	wejy
銝	wefv
鋲	weft
鍰	wehb
缼	weio
鎐	wewo
銩	wevv
鋌	wexn
鋢	wevk
鈋	weri
燞	weuo
蜰	wckc
厽	vvvv
厸	vvvv
亝	vvvs
皰	vwck
孴	vvvj
毿	vvvr
遪	vvvp
叅	vvvo
剼	vvvm
孻	vxfm
熋	vwru
劺	vwxk
螚	vwrk
弜	vvgg
彅	vuwb
纼	vvns
孡	vvlv
鎇	wbmf
鐴	wblo
鉧	wbmj
鈬	wbod
釰	wbod
鏆	wbdm
釖	wbdj
鈻	wbbu
腞	wbds
鐑	wbhl
鐙	wbfu
鍨	wbfg
躵	wboy
鈀	wcbj
錒	wcal
鍲	wcaj
鈱	wcai
鐉	wcct
鐊	wcjt
鍏	wcij
鈮	wbri
腵	wbsb
鍜	wbsb
犌	wbsb
鋦	wbvl
叐	wbuk
銿	wbtn
鎟	wbbf
孞	vyik
孧	vxvk
彇	vxtf
鉺	warj
釮	waqp
腏	wbbb
牱	walv
鋷	wabu
鈳	walv
鐂	wagj
鎶	wall
酁	ylrc
叴	ylvf
吢	ylvi
飷	ymis
冝	ymim
懌	ymhd
愲	ymgi
蠫	ymkk
憈	ymkg
懁	ymfr
悞	ylxg
敆	ymbu
饠	ymbw
烉	yktu
愪	ylmb
龣	yllk
憒	ylkm
龡	ylle
貚	ylld
慺	yldc
貗	yldc
勨	yldx
粂	yopm
飰	yomo
餏	yory
愃	yoff
飳	yogn
怺	yokv
饝	ypdh
懡	ypqv
愱	ypqi
戂	ypli
悙	yovl
悓	ymxi
鼏	ymxt
饖	yndm
𠂊	ymmm
㣺	yodi
饄	ynht
憆	ynht
慖	yngf
饓	ynfv
怬	ynqr
戃	ynne
恛	ynlv
餇	ykfl
餖	yflu
餷	yfjf
怲	yfkt
餞	yggg
慪	ygll
惐	yglf
餣	ygkd
餴	ygds
悑	yfui
顐	ygdm
鄆	ygcj
愋	yehb
餭	yegn
餱	yebq
貃	yebk
餁	yeen
惞	yeei
冧	yffv
忨	yfhw
悿	yfgo
冟	yeri
貕	yevg
餺	yfac
愮	yewo
惈	yjfv
饂	yjmn
憴	yjmi
惼	yinc
餢	yilv
悩	yiwx
畣	yjte
蛗	ykcd
愢	yjyi
鼆	yjoj
鄍	yjoc
懪	yjsk
饆	yjsa
惃	yjrr
麁	yilm
怽	yhei
餦	yhas
憓	ygyi
怴	ygxi
忓	yhgi
豻	yhgk
憢	yhhh
恄	yhlv
憘	yhll
懛	yhlh
恎	yhki
怈	yhii
饉	ygsi
鶤	ygro
慡	ygww
忲	ygod
悈	ygsj
皸	ygvp
懄	ygsx
慞	yijd
慠	yhwe
饁	yhvm
懩	yugv
怑	yuao
亇	yvim
憦	yuux
餤	yuuo
貖	yutm
餹	yuxl
觪	ytox
觬	ytrq
鵤	ytro
飹	ytms
愴	ytol
餩	ytoi
觲	ytuw
觮	ytxk
觾	ytsu
觵	ytst
搻	yttu
飻	ytto
愶	yxxw
飿	yxxg
貀	yxxg
憳	yxfa
忇	yxki
貇	yvnk
惂	yyrj
怭	yyqp
橤	yyyf
繠	yyyb
忰	yydi
餫	yygc
饞	yylo
愌	yykg
貄	yxao
怉	ywck
隺	ywim
怶	yvpi
厹	yvvf
餕	yvte
惍	ywji
愡	ywty
㥮	ywxx
餙	ywsm
豿	ywlv
怐	ywlv
懏	ywkf
饡	ywqm
豼	yrri
鴭	yrod
恀	yrrk
懙	yrst
憁	yrey
餰	yria
愼	yrmt
饚	yshm
厃	yshm
冩	yrwu
憡	yqfk
怢	yqgu
貁	ypxk
愹	yptl
瓭	yqaw
飥	yqai
鴓	yqro
餆	yqss
憮	yqsu
沊	yqkv
貈	yqok
忛	yqod
覕	yqmx
觻	ytef
悇	ytff
惀	ytfn
觨	ytfk
懀	ytfj
怟	ytao
忯	ytai
觩	ytfo
觛	ytjf
觶	ytld
恮	ytgn
㓁	ytim
觰	ythj
飠	ysss
餝	ysog
懨	ysjs
饃	ysjg
愺	ysjd
恠	ysnh
懱	ysmo
貛	yslw
饊	yswe
忶	ysvv
憽	yswy
餀	yswl
甔	ysta
鈂	wyqr
鉍	wyqp
忎	wyik
釻	wyod
肒	wyod
鋔	wylq
鑱	wylo
衋	xadm
鉫	wxlv
牞	wxkn
鉯	wxot
釛	wxkj
鐞	wxfa
釓	wxij
鋟	wxyb
脇	wxxx
鑃	wxxw
鍕	wygc
肍	wyfy
勼	wyfy
匌	wyey
鉿	wyej
匓	wxvq
鈯	wxxg
牃	xhfv
娤	xhcn
丱	xggg
丩	xggg
夨	xgdi
焋	xhuo
銺	xhwj
妛	xfcn
⺻	xfil
彠	xflb
鎆	wuwm
錓	wuxi
犫	wuww
釯	wuwj
讎	wuwi
躿	wuxk
鏞	wuxw
魐	wuxt
鎕	wuxl
膅	wuxl
鉱	wuvv
鑅	wuuf
鎰	wutm
犪	wute
鐒	wuux
腅	wuuo
錟	wuuo
鏹	wvlk
釕	wvlj
錙	wvjt
鈶	wvlv
鈏	wvns
犣	wvnb
鍿	wvfj
釢	wvjj
釔	wvij
䲢	wugq
鎹	wugp
膡	wugm
爒	wugm
賸	wugm
羘	wugy
錈	wugv
犈	wugv
鏳	wujj
軈	wuey
鎈	wufo
躾	wugd
鉳	wuri
邎	wuqp
鷦	wuro
鐠	wukj
灳	wuoy
缹	wuoo
鈥	wuoj
鈟	wvns
肳	wwto
憌	wwsy
鐎	wwuo
鍯	wwty
鍃	wwty
肑	wwod
牪	wwnn
鍤	wwrj
銑	wwqr
鑁	wwxe
鍐	wwxe
甧	wwwy
朤	wwww
犓	wwxx
胷	wwxw
鎸	wwvj
匑	wwvg
銏	wwwf
鋾	wwwo
雦	wwwi
雥	wwwi
雧	wwwf
鈝	wwnj
鑂	wwne
魕	wvvt
鏒	wvvt
犙	wvvt
鎨	wwdi
褜	wwcr
臐	wwne
膷	wvqc
鈹	wvpj
鈗	wvqr
鐨	wvtm
鉘	wvti
鋑	wvte
匔	wwll
釺	wwkj
鋯	wwlv
銵	wwmj
鐫	wwkf
鏶	wwfv
鎩	wwfq
鉎	wwgj
銁	wwjr
錭	wwhl
芔	xxxg
姭	xxxc
翑	xxwl
辥	xyox
冣	yabu
翞	xxom
糶	xxpw
鷚	xxtr
剹	xxtm
雡	xxtw
鄝	xxtc
翵	xxro
翐	xxqg
翇	xxso
忊	yani
憛	ydjd
饢	ydlr
頧	ydmb
懳	yddy
顊	yddm
怌	ydfi
頄	ydmb
飣	yans
饙	ydsm
餑	ydyv
懥	ydyn
貑	ybsb
餯	ybds
憜	ycsw
饌	ycct
怓	ycbu
帬	xqlm
彞	xpbs
鵘	xqlr
裠	xqlr
夛	xrkl
帇	xmvl
乫	xlvi
嗧	xltn
毠	xlrm
翨	xxjn
翄	xxdb
劜	xxik
翋	xxid
翴	xxgp
槩	xvgf
牄	xtol
歗	xtxe
墏	xwah
鱀	xvgt
堲	xvxh
鯫	tabu
氒	tadi
蘂	syyf
葪	sytm
鮿	taxi
魨	taxg
鸏	syfr
蒏	sygo
鹲	syfy
菷	sxym
凕	syjt
蘥	syln
薶	sykk
藑	syke
蘬	synm
鯕	tdjy
鱩	tdjt
鱏	tdjd
鯐	tdky
澃	tdmk
嬃	tdmc
鯠	tdly
鮖	tdhy
鰄	tdfc
魾	tdfi
鰾	tdhs
鰔	tdfl
魬	tebu
鯸	tebq
鮒	teac
鱈	tdxl
鮊	teby
鮾	tecn
鮜	tefl
鱝	tdsm
鱁	tdpd
鰢	tdmy
鯎	tdvi
鮉	tblv
牊	tblv
鰠	tbok
魢	tbjy
郋	tcjk
鱊	tcql
鰇	tcqf
鰕	tbsb
鱍	tbvq
炃	tbuo
鯒	tbtn
鮴	tefv
蓀	svqb
苐	svnq
苰	svvv
蒛	swbt
孶	svvv
菧	suto
蓙	suth
薕	suut
蓔	suuo
苂	suoj
苝	suri
萾	svbm
葞	svar
葥	suwm
蓎	suxl
橜	suxf
憠	suxy
荕	swxk
葼	swxe
萠	swwy
蕁	sxfa
荍	sxeh
茟	sxao
蕂	swux
蔒	sxqu
蔇	sxvq
莭	sxvx
艻	sxkj
凎	swji
龓	swim
雈	swij
菳	swjj
蟼	swlk
﨟	swjx
蔱	swfq
朢	swgn
戫	swgf
葄	swqm
莃	swsm
苅	swmd
厒	swoh
蘍	swnx
敓	tlqe
尒	tmae
鯡	tliy
鰐	tlls
鱢	tllf
魦	tmqp
鯱	tmuy
鱰	tmhj
鱡	tmgs
鱞	tmfr
魝	tmdy
䦆	tmmb
鱋	tmkg
鰛	tjmn
仚	tjse
鰻	tjmb
鯷	tjfn
鰑	tjft
鯧	tjjr
鱪	tjhj
魻	tkjy
魶	tkte
鰓	tjyi
鰨	tjxx
鯣	tjwt
鮦	tkfl
鱭	tous
鰟	touo
鮫	totw
鯲	tots
酓	tovg
欦	tove
敜	tove
鰝	toly
毈	tooq
魧	toqj
辠	toxk
戧	toxg
鯙	tovk
鯍	tovq
雂	tovw
侌	tovv
丯	tnso
頿	tnrm
鱥	tndm
鯝	tndg
鰮	tntm
鴒	tobr
鰚	toff
鯇	tofh
鰘	tohk
魴	togy
鼼	tjax
鰊	tfnu
魳	tfmv
鱺	tfki
鯄	tfko
朇	tfjd
臰	tfrr
鱳	tevf
臮	tett
鮲	tesq
甈	tfaw
牔	tfac
鱫	teye
鰩	tewo
鰀	tehb
鮘	tegy
鰁	tekv
鰷	tenf
鯦	teml
鮥	telv
侴	tfbm
厁	tffx
雓	tffw
鄶	tfjc
魭	tfhw
魱	tfbm
鯃	tfcl
嵞	tffj
魲	tiey
鯜	ticn
鯿	tinc
鯋	timq
鮃	thue
鯪	thte
鮳	thsk
䥺	thyj
鯖	thwy
鰪	thvm
齇	tjam
齈	tjas
齅	tjas
齀	tjaa
齂	tjak
䦂	tixx
鼿	tjah
鯂	tgoy
鰆	tgjr
鰋	tgjc
鮱	thri
鮔	tgbu
鮬	tgfs
𠔉	tgui
鱚	thll
舗	thlf
舘	thlb
鰰	thke
鯺	thjr
鵨	thlr
鰿	thmb
鮚	thlv
鰳	tgxk
鮧	tgvg
鱙	thhh
鰈	thfv
鮇	they
贒	slnm
蒷	slmb
蓶	slwi
荶	sltv
虈	slll
顴	sllm
飌	sllr
鸛	sllr
蘄	slle
凙	smhd
藈	smbg
蕜	slyi
黆	sktq
萞	sktr
薱	skua
黅	sktv
黊	skth
黈	sktg
黇	sktl
茣	slfg
蕇	slld
鄿	sllc
酄	sllc
蕢	slkm
勱	skxk
菵	skuu
蕄	skyi
厛	slej
蔞	sldc
蘃	snnf
荹	snma
蔮	sngf
薗	snhr
荌	socn
藃	soei
藼	sody
蒕	sntm
莔	sntk
苬	snte
莡	snvj
蔨	snuv
萀	smuj
蘮	smsm
萛	smsj
薒	smrp
藣	smvr
芇	smvj
蔖	smmi
萴	smmd
蕒	smmb
蔝	smpm
萈	smod
萷	smwm
薉	sndm
顭	smym
鄸	smyc
蘉	smyb
莇	smxk
莧	smxj
莦	smwy
薎	smyg
虃	sitf
蒤	sitf
薻	sivf
蔢	sivc
菭	sivl
薀	sinm
蓅	sioq
薃	siol
蘴	sjdu
厬	sjel
莐	siyq
萢	siwc
蒅	siyf
薓	sixb
菺	siwy
薸	sidh
菬	sibl
藙	sidq
蔜	shwe
羐	shyo
苉	shxi
萻	sijr
蔋	sikb
菃	sigb
藽	sifm
薼	siht
蔆	sihe
凒	sjfu
虄	skew
鶧	skgr
蔅	skcn
覯	skhm
懕	sjwy
莮	sjxk
顜	skhm
荝	skmd
蕽	skss
茮	skma
蠆	skkc
蔄	sklv
蓾	sklj
荲	skkj
龷	sjjj
蕌	sjjj
卝	sjjj
蘲	sjjh
蘽	sjjf
茰	sjwl
厴	sjwk
凗	sjwi
嬮	sjwc
剒	sjmd
逪	sjpd
鶓	sjro
葃	sjqm
逽	sslp
蠚	sslk
藶	ssrn
荋	ssrj
莀	ssnj
葐	stbm
茋	stao
刱	stbt
蕦	stdm
燛	ssuo
蒝	ssem
蘒	sryk
萟	sryo
蕵	srys
苃	ssbu
菣	ssbu
冹	ssbo
藖	ssbm
蘳	sskh
蘣	sskg
蓤	sshe
臩	ssgt
葁	sucn
虊	subf
冸	suao
莝	stth
遳	sttp
蔊	sujh
莌	sulq
菤	sugv
蕿	sueb
蒫	sufo
蓭	sugk
坓	stht
蛬	stkc
蒥	stjt
輂	stgc
菕	stfn
汬	stkv
蓌	stte
苚	stnj
莟	stol
蘱	spsm
藱	spwu
䓖	spxk
厇	sqai
蘺	spxw
蒾	sppd
譼	sqmu
擥	sqmt
厏	sqmo
苵	sqgu
萭	sqkk
芁	sqjj
𠂇	soo
萓	somi
蔙	soqn
苀	soqj
薧	sofr
藔	sogm
凉	solm
薲	sofm
蔲	sofe
荢	sofa
茡	sovk
藡	soup
藌	soyk
蔤	soyj
薴	soya
蓢	soxw
厗	soxh
蓈	soxc
藆	sost
萒	sotq
蔏	soul
蔐	soud
蓘	sotr
蔉	sotr
蕮	srwu
磿	srrd
蓹	srqx
蘈	srqm
蒈	srre
蘔	srrm
茤	srrk
蔦	sroj
鳫	sroh
蕱	srmw
鴯	sror
蘒	srqj
蘌	srqh
菞	srwq
蕛	sruq
蕕	srug
蘓	srty
蓯	srtn
藇	srst
萪	srsd
鍳	sqwj
苸	squa
莥	srbc
茒	srcj
凞	sqsu
芞	sqqj
蒰	sqqh
蘞	sreh
藊	srin
虋	srkb
蒩	srmi
萂	srlv
薟	srlj
芕	srkj
葕	sria
蘝	srei
蘏	srhm
蕏	srhj
薐	srhe
炿	uqwo
譗	uqye
庅	uqvv
鲝	uqyg
廎	urdm
灮	uqro
巟	uqrw
譕	uqsu
烑	uqss
庣	uqss
羷	urlg
譣	urla
鴹	urog
謏	urnb
煈	urfo
丠	urfi
秌	urho
廭	urhm
詸	upma
焪	upvg
羫	upfo
烐	uqoo
炈	uqho
烅	uqmn
讛	ushv
鄺	uskc
諎	usjr
庴	usjr
灷	usjo
鷓	usfr
廗	usfm
剫	usfm
煗	usgd
庻	usft
誫	usna
爁	usqm
爦	usqm
讈	usrn
爏	usrn
爡	uskk
燤	usky
煍	uruo
鄁	urwc
熪	urrr
謜	usem
諮	usel
炓	usdi
誮	user
烥	usco
剙	usbt
炦	usbo
剏	usbo
詙	usbo
炾	ulqr
訲	ulns
吂	ulvw
讉	ulkp
熉	ulmb
燀	ulld
讝	ulle
諤	ulls
爈	umjy
燡	umhd
譃	umkg
炶	umlv
詀	umlv
灲	umdo
詃	uovo
炠	ukjo
爞	ukkk
庘	ukju
詇	ukgd
讕	ukfu
朚	ujwy
詗	uklv
燗	ukwy
譋	ukwy
爜	ukub
焹	ukuu
焵	ukuj
熡	uldc
廔	uldc
諿	ular
庽	ukyu
焨	uksw
燶	ukss
譨	ukss
謯	ummi
燺	uofv
諚	uofn
羦	uofh
焲	uoeo
爙	uolr
熍	uoll
烗	uoio
譹	uods
諪	uoan
謪	uoul
謫	uoud
烄	uotw
誏	uovn
羪	uovn
譈	uove
燣	uonr
燷	uonh
讅	uoqj
庡	uory
焥	uorv
炨	uori
鐅	umtw
訬	umqp
謼	umqa
嫳	umtc
爘	umry
譡	unjt
訨	unia
爅	unht
爣	unne
訵	unqr
煾	ungy
諣	unaa
誢	umxa
誚	umwy
焑	unfv
爋	uwnx
訋	uwod
詵	uwqr
諊	uwpm
烿	uwot
焳	uwio
諥	uwkk
廫	uwxt
詜	uxbu
屰	uxge
欮	uxei
訩	uwxg
誵	uwsw
焩	uwwy
訤	uwwl
詪	uvna
訠	uvns
爉	uvnb
憥	uuyy
謲	uvvt
蠯	uwdk
螷	uwdk
焷	uwdi
鶿	uvvr
訯	uvod
甆	uvva
炥	uvti
羛	uvti
譫	uysu
訦	uyqr
熓	uywo
讑	uyln
訙	uyod
焔	uynj
熻	uyxx
丮	vaoi
彁	vall
鶼	uxnr
鶊	uxtr
賡	uxtm
鄌	uxlc
劷	uxkg
甉	uxna
誛	uxyb
烚	uyeo
訅	uyfa
讂	uyke
熐	uyjt
応	uyiu
悥	uyia
鷛	uxwr
羗	uxvv
熮	uxxt
炪	uxxg
詘	uxxg
焾	utoy
諗	utoy
訡	utov
庈	utov
謒	utol
炩	utob
噵	utpl
詯	utka
鷁	utmr
詤	utxq
焧	utvy
庺	utvf
鮺	utyg
詊	uuao
炌	utti
焀	uttl
庎	utti
鎣	uuyw
烠	uswy
爑	uswu
烵	uswo
詴	uswy
烡	usti
燪	uswy
庂	uteu
庩	utff
燴	utfj
廥	utfj
艵	usyc
訜	utbd
諙	utaj
譧	uuut
謭	uuwb
焍	uuvq
譱	uuua
爃	uuuf
羴	uuug
滎	uuyk
𤇾	uuym
醟	uuyg
謍	uuyu
熒	uuyu
褮	uuyr
檾	uuyf
譾	uuwx
劆	uuxm
熑	uuxt
煢	uuyd
甇	uuya
煪	uugo
烾	uuht
歚	uule
敾	uule
諩	uukg
熫	uusu
譢	uudp
顃	uudm
烪	uugd
譐	uuga
鶑	uuro
庰	uusj
燨	uuqg
敥	uumb
炏	uuoo
顲	uuom
鰺	tvvt
鶲	tvxr
勜	tvxx
鮑	twck
鹟	tvxy
魥	tvod
鱜	tvqc
鮍	tvpy
鮄	tvti
鰯	tvss
毤	tvqr
鯴	tvqk
魡	twod
魩	twto
鮢	twti
鯑	twsm
鮏	twgy
鯌	twlv
鯯	twkm
鰌	tugo
鱒	tuga
鱶	tugv
鮵	tulq
鱛	tujj
鱃	tubc
牉	tuao
枀	tvfv
鯵	tvgt
鮐	tvlv
鯔	tvjt
乮	tvim
鱅	tuxw
鮩	tusj
䦅	tuul
鰦	tuvv
鮷	tuvq
龵	tuuu
炣	ualv
鵥	uamr
讘	uaaa
訁	uaaa
廰	uady
頖	uadm
䜌	ubbs
孿	ubbv
灱	ubdo
庉	uaxg
孌	ubbc
諁	ubbb
灓	ubbk
欒	ubbf
卛	ubbd
鮠	tysv
臫	txik
亾	txie
鱘	txfa
仺	txle
劧	txku
鯼	twxe
鱌	tyld
鮅	tyqp
鱐	txtf
鮶	txql
鄎	tycj
鯞	txym
鮼	txyb
鮙	txxi
鱂	txwa
鯚	trvk
魞	truy
鰹	tsbh
鮁	tsbo
鄓	tscj
魹	trmy
鯏	trmd
鷠	troy
魮	trri
佱	tsni
鱴	tsmo
鱹	tslw
鰖	tsfw
鰽	tsjj
鱵	tqdl
鰒	tqje
鰫	tptl
臱	tpog
魰	tpwy
鯀	tqbs
鯅	tqnx
鮓	tqmo
鱕	tqpj
鮡	tqss
谼	ttlt
鵒	ttlr
逧	ttlp
螸	ttlk
豅	ttlm
豄	ttlm
魪	ttti
鯰	ttoy
睂	ttnm
魸	ttpy
鱯	tswb
臯	tssd
鷱	tssr
鰙	tssl
鱱	tssk
夎	tthe
谻	ttla
鯩	ttfn
鱠	ttfj
謰	ugpd
詽	uhhg
詿	uhht
譊	uhhh
羠	ugvg
觠	ugyt
駦	ugdm
詎	ugbu
諽	ugea
烒	ugfo
煂	ugeo
勬	ugbx
絭	ugbs
爩	ufwt
謳	ugll
讍	ugll
廤	uglr
帣	ugmv
齤	ugmc
譛	uggj
⺶	uggg
𦍌	uggg
諓	uggg
譇	ughj
誈	uhka
熴	ujjr
誯	ujjr
熀	ujmh
謾	ujmb
譝	ujma
諹	ujft
燳	ujbu
熶	ujab
詚	ujfi
焺	ujqs
朆	ujut
焬	ujwt
讗	ujwl
謃	ujwg
爗	ujss
煓	ujsr
熼	ujst
謆	uixx
燽	uhva
譸	uhva
燵	uhup
庨	uhvk
誟	uhvk
謸	uhwe
詓	uhvv
熆	uhvm
廅	uhvm
譆	uhll
庢	uhku
諘	uhry
諞	uinc
熩	uilc
燑	uikk
譩	uijy
燱	uijy
爖	uiwm
羻	uive
詶	uiqc
庌	uhyu
驘	udmw
燌	udsm
烼	udso
謤	udhs
誺	udla
諵	udkd
諆	udja
羺	udsr
奨	ueag
詂	ueac
熢	uedp
炍	uebu
炋	uduo
燯	udtb
煁	udxi
謘	ubox
譅	ubon
謣	udfs
爥	ubkk
廜	ubhj
訍	ubod
緳	udbb
煘	udfl
燍	udej
譿	uddy
煀	ubxx
煣	ucqf
讔	ucey
諨	uflj
諃	uffv
訮	ufsj
炑	ufvo
烴	ufvf
庯	ufuu
烳	ufuo
烞	ufmo
齹	ufmc
炢	ufod
訌	ufoa
謕	uemu
詻	uelv
燆	uell
燩	ueoe
烌	uefv
詬	uefl
諻	uegn
諼	uehb
庍	ueju
炇	ueho
訛	ueri
炛	ueri
烶	uexn
譌	ueww
譍	uewu
熎	uewo
謡	uewo
煿	ufac
諈	uesj
廏	uerq
謟	uerj
烰	uevk
謑	uevg
傏	euxl
嗠	evel
偂	euwm
偝	eurw
僗	euux
僐	euul
儝	euuf
偦	evnw
伄	evns
儠	evnb
仱	etov
僋	etom
傖	etol
侳	etth
倽	ethl
仈	etie
僔	euga
傠	euac
倊	etvy
伜	eydi
欇	faaa
㑇	eyxl
橊	fagj
桺	fagb
伔	eyqj
偩	eymb
倹	eyte
倠	ewie
鄬	ewcj
偅	ewkk
仢	ewod
噕	ewlv
佨	ewck
俷	ewcb
僟	evvt
頲	exdm
㑳	ewxx
倗	ewwy
劤	exkj
劰	exkb
俙	ewsm
爳	ewvl
伆	ewto
伩	epwe
侎	epme
儕	eous
俲	eotx
俼	eovw
侜	eqoe
倁	eqlv
皒	eqag
偨	enrf
鎥	enew
鋚	enew
焂	eneu
偯	eory
倇	eorv
儫	eods
俕	eofv
俒	eofh
譥	eoeu
僙	eskt
傋	eskh
偀	eskg
儚	esmr
侟	esnv
儖	esqm
僀	esfm
傼	esfg
儰	esew
皣	eshs
僃	eswt
佄	essi
儮	esrn
侕	esre
傆	esem
墍	ergh
傁	ernb
覛	ermx
俰	erlv
佲	erlv
曁	ergf
佸	eree
伖	esbu
鴁	eroo
傱	ertn
坖	fhht
橈	fhhh
棖	fhav
梜	fgtt
樲	fgsm
桋	fgvg
枎	fguv
兘	fhvl
橽	fhup
梽	fhyi
榬	fhlr
椡	fhmd
樍	fhmb
橲	fhll
榸	fhkk
榰	fhrj
梇	fgsj
槫	fgac
棾	ffyq
槬	fgfq
蝅	fgfk
櫕	fggm
翉	ffxx
鴌	fgro
櫮	fgll
貮	fgmb
鵡	fgnr
迗	fgpd
梄	fgov
椻	fgjc
昋	fgjr
奣	fgjw
郠	fjwc
欈	fjwl
鶇	fjro
鵶	fjro
楐	fjtt
梤	fjtb
杣	fjsv
楒	fjyi
橍	fkgn
柍	fkgd
邐	fkfp
彲	fkft
橺	fkjr
螙	fkkc
櫊	fkel
桛	fkak
婯	fkfc
櫦	five
﨔	fitt
椖	fiog
栦	fiqc
櫳	fiwm
樶	fjab
枦	fiev
樚	filv
樈	fijq
樴	fijg
槾	fjmb
欙	fjjb
刯	fjfm
棏	fjfa
琧	fjgo
椳	fjgf
皶	fjfv
榿	fjfu
櫘	fddy
楆	fdcn
櫀	fdbs
楲	fdfc
櫏	fdgp
椷	fdfl
忢	fcyi
逜	fclp
櫲	fcyd
橭	fdox
樮	fduo
橒	fdsv
檽	fdsr
橨	fdsm
橶	fdjg
樭	fdht
檦	fdhm
榪	fdmv
欜	fdlr
朷	fbdv
樌	fbdm
欚	fbdk
檰	fbem
欘	fbkk
楑	fbfg
瓨	fawo
枾	fati
栮	farv
杶	faxg
櫞	fbbd
橻	fbbb
棳	fbbb
榌	fbkv
梞	fbyi
樼	fbvv
橃	fbvq
樄	fcfj
杒	fbod
栂	fbmv
柖	fblv
梕	fboy
榐	fbsg
榃	ffjt
梂	ffko
欐	ffki
栜	ffkf
栵	ffrm
檷	fftw
辳	ffsn
枅	ffsj
梪	fflu
楋	fflm
楅	fflj
椘	ffpe
杢	ffov
柾	ffni
栰	fegg
檼	fefy
椞	fefv
梹	feft
椺	felf
楾	fekv
蜤	fekc
梍	feai
樰	fdxl
櫌	fdwe
栙	feao
梔	fefc
桵	fecn
梺	ffak
樷	ffab
惁	feyi
橓	feya
杅	ffau
桏	ffcj
榣	fewo
櫾	fewb
枖	feov
梻	fevt
榹	femu
梎	feri
槄	ferj
榽	fevg
櫟	fevf
橷	feuq
檪	fesf
槹	fesd
趭	dwuo
騘	dwty
駯	dwti
靃	dwwi
砃	dwob
馰	dwod
趜	dwpm
赹	dwsi
鸖	dwro
靍	dwro
鶘	dwro
礸	dwqm
趲	dwqm
鶈	dxcr
硉	dxao
騶	dwxx
鄾	dwyc
碯	dvrw
雭	dvod
矷	dvkh
駘	dvlv
豞	dwlv
騆	dwhl
霌	dwhl
甤	dwgs
碒	dwjh
趛	dwjk
尰	dwkk
駨	dwjr
霛	dvvv
驂	dvvt
愂	dyvy
鵓	dyvr
駜	dyqp
馾	dyqr
姇	eacn
頱	eadm
倳	ealx
夦	dxrr
磖	dxxe
趢	dxkv
勑	dxkl
赲	dxkk
尠	dxmq
愸	dxyi
霥	dyfd
硆	dyeh
跾	enen
頛	dtdm
硢	dtff
騟	dtfm
靀	dsyd
赿	dtai
碈	dtaj
砏	dtbd
趆	dtao
耓	dtan
耝	dtmi
駠	dtmm
駖	dtob
砽	dtnh
耡	dtmx
䎬	dtmv
䎱	dtmr
耫	dthm
騇	dthl
硂	dtgn
駩	dtgn
騮	dtjt
礛	dsqm
礰	dsrn
猌	dsql
礷	dssm
礶	dslw
歕	dsme
翸	dsmx
礣	dsmo
霒	dsvv
霼	dsvp
霕	dsvx
磭	dswy
硔	dsti
靅	dsvm
霴	dsvk
驓	dujj
礒	duqg
驣	dugd
礢	dugv
磸	dugg
磀	duxp
尲	duxt
尮	dvfv
磏	duxt
磰	duul
礯	duub
騚	duwm
砿	duvv
磱	duux
耯	dtsb
砎	dtti
赺	dtov
砛	dtov
耲	dtor
耚	dtvp
諅	duaj
駗	dtto
耣	dttn
賫	dttm
𠂆	ejjj
僈	ejmb
皔	ejhg
偣	eijr
傹	eijq
儱	eiwm
傽	eijd
偐	eiqt
傝	ejxx
邍	ejxp
敒	ekeh
灥	ekek
爫	ekkk
倱	ejrr
儤	ejsk
儶	ejwl
儑	ejvu
侺	ejtv
侇	egvg
僡	egyi
倀	ehae
偞	ehfv
佅	ehee
鶢	ehbr
仠	ehge
僆	egpd
偧	egrr
傄	egum
坕	ehtk
儓	ehlh
侤	ehsk
偖	ehjr
皌	ehob
儢	emjy
儏	emrp
偗	emqm
歋	emei
傦	emge
䴘	emya
僘	eneh
俿	emue
偼	emxn
俔	emxe
賲	elfm
敋	eleh
僂	eldc
敿	elke
侱	elgn
仩	ekse
伣	ekxe
諐	elqu
仦	emae
洜	elkv
僺	ellf
勪	elkx
儙	elkp
僓	elkm
傊	elmb
偔	ells
仼	egne
僨	edsm
頎	edmb
俖	edlv
傶	edkm
仹	edne
斦	eejj
栠	eefv
俻	eejt
傂	eemu
劕	eemm
賃	eemb
啠	eelv
俀	eecn
佭	eeao
皛	eeeb
儨	eeem
俽	eeei
皨	eeeh
鄇	ebqc
伬	ebod
僛	edei
偠	edcn
偰	edbg
儎	edgg
佦	edhe
侞	eclv
鵎	ecro
鵂	efro
倯	eftv
仜	efoe
侀	efsm
垈	eght
柋	egfv
儧	eggm
俴	eggg
侢	egkf
帒	egmv
傴	egll
侙	egfo
恷	efyi
僌	egeh
仾	efbm
皧	eeye
僢	eeya
傿	efnu
侸	eflu
劶	eflx
俹	efja
倵	efgn
倲	efjr
儷	efki
醆	gggg
戔	gggg
夶	ggdd
邼	ggcj
奆	ggbu
鄻	gggc
軖	ggnc
輏	ggoc
虦	ggmu
轋	ggpd
珡	ggte
轃	ggrh
匲	ggll
瓎	gflm
弌	gfiy
輌	gfkj
瑼	ggac
玒	gfon
匞	gfof
韀	gisu
軶	givi
奫	gitf
鞛	gilv
轆	gilc
輥	gjrr
瑅	gjfn
輠	gjfv
輰	gjft
轠	gjjj
瑇	ghbm
鞢	ghfv
琽	ghjr
玴	ghin
酜	gguo
轑	ggum
匧	ggtt
璤	ggyi
匭	ggyf
醻	ghva
玶	ghue
輘	ghte
圶	ghtd
輤	ghwy
鞊	ghlv
瓄	ghmm
珯	ghri
酛	gfhw
鞸	gjsa
叀	gccc
瓍	gcsp
瑈	gcqf
邞	gcju
瑉	gcaj
醗	gbsq
璏	gbrr
巪	gbvi
乬	gbvi
醥	gdhs
韆	gdgp
轊	gddx
輱	gdfl
珬	gdfi
軘	gaxg
珁	gawn
酠	galv
瑂	gbmf
軺	gblv
玿	gblv
靫	gbod
瑻	gbdm
靵	gbce
蹔	genv
軠	genc
覱	gemx
轁	gerj
珸	gfcl
醂	gffv
璴	gffn
匸	gfff
瓅	gevf
轢	gevf
酻	gevk
琈	gevk
轜	gdsr
逩	gdsp
瓇	gdwe
頊	gdmb
琜	gdln
輴	gedm
槧	gefv
瑖	gefq
轌	gdxl
磛	gedh
玔	gqcn
玝	gqdi
繋	gqbs
朁	gqgj
珟	gqfr
轔	gpra
醾	gppm
珴	gqag
軓	gqod
匴	gqms
嫛	gqqc
輧	gqhh
軗	gqhc
瓋	goup
迏	gopd
迋	gpdn
釄	gpli
斳	gsej
歏	gsei
瓈	grwk
軷	gsbo
憃	gryi
轥	gskw
韊	gsku
瑌	gsgd
韉	gsiu
夳	gsid
冭	gsid
鞾	gshs
璍	gshs
鞂	grhe
悘	gqyi
軤	gqua
璵	grst
醶	grlo
匳	grlf
軞	grmc
戜	glgn
輫	glic
鞼	glkm
甌	glla
靧	glkm
鞻	gldc
軹	glti
毄	glqh
軙	gmbu
珼	gmbn
夵	gmad
琄	glwy
釅	glle
匰	glld
剾	gllm
鞐	gkak
奛	gjwy
輵	gjwx
輲	gjsr
軕	gjsc
琾	gjtt
瓗	gjwl
韅	gjvu
琠	gkst
靹	gkte
軜	gkte
輞	gkuu
醠	gkgm
軮	gkgd
剦	gkmd
琡	gkmb
珿	gnvn
鞝	gnse
珚	gngd
玣	gomo
輬	goma
奒	goid
璌	goft
琔	gofn
璸	gofm
輆	goic
琓	gofh
輐	gofh
軴	gogn
鞇	gngd
轤	gmjm
靻	gmie
輄	gmhw
瓔	gmmc
嫢	gmcn
醳	gmhd
槼	gmfv
輎	gmwy
鞩	gmwm
奯	gndm
匷	gmmw
椌	fpfo
辷	fpdi
桹	fovn
橀	fovm
櫅	fous
棛	fovw
橣	foyt
櫁	foyk
樒	foyj
怸	foyi
怷	foyi
檱	fqdj
杊	fqcv
杔	fqai
槉	fpqi
柼	fpxv
楴	foum
鶫	fnur
榲	fntm
橴	fnrb
柶	fnqr
棞	fnrh
鴊	fnro
樀	foud
檹	foql
鶐	fopr
檁	fonr
櫰	fomr
橠	forr
棜	fots
椬	fomi
欀	folr
棭	foeo
楁	foel
樎	foej
櫶	fody
檺	fods
槣	fogl
堏	foht
榁	fohk
殌	frff
殐	frfl
樬	frey
栺	frjr
槝	frjs
殨	frlm
㱮	frlk
殫	frld
楿	frjr
殎	frgt
殟	frjm
殗	frgk
殕	fril
柇	frhv
権	fqfw
杋	fqod
聓	fqoa
樦	fqog
柉	fqpe
巬	fqgu
櫡	fqhj
椥	fqlv
楀	fqkk
櫷	fqjm
椱	fqje
榤	fraf
桝	frao
桞	frcj
枡	fqsj
橅	fqsu
櫤	fqum
柧	fquv
橁	fqwj
杚	fqvi
欓	fnne
鬸	flkj
慗	fley
疈	fljj
棑	fliv
揧	flmt
槵	flly
鷊	flkr
樿	flld
梙	flln
楍	flll
欕	flle
栧	fkqp
慦	fkoy
椣	fkst
檂	fkss
欁	fksf
皳	fkov
椚	fknv
櫩	fkyr
遬	flep
櫢	flde
橌	fkwy
㭎	fkwl
棢	fkuu
檏	fkut
鳾	fmro
椇	fmti
榩	fmpw
楨	fmmb
檌	fmli
櫖	fmjy
櫨	fmjm
欋	fmmw
樝	fmmi
靕	fnhw
椢	fngo
槶	fngf
栶	fngd
檲	fnga
杫	fniv
楇	fnav
慐	fmyi
䴓	fmya
檙	fmxt
頙	fndm
檅	fndm
剅	flum
毭	flur
豏	flut
豍	flud
郖	fluc
欏	fmbw
梖	fmbv
檈	fmfr
梋	flwy
朰	fviv
乶	fviu
坙	fvht
椮	fvgt
桳	fvgd
椔	fvjt
櫇	fvdm
巰	fvfq
剄	fvfm
柌	fvfl
榒	fvss
桙	fvwn
楈	fvnw
櫠	fubq
椨	fuea
橂	fugg
栚	fugd
榳	fuex
杽	ftuv
鵐	fttr
覡	fttm
棩	ftxf
棇	ftvy
枩	ftvv
橩	fuuq
檆	fuul
樜	fusu
檤	futp
榏	futm
橯	fuux
槏	fuxt
椩	fuxt
榶	fuxl
杧	fuwv
椾	fuwm
櫎	fust
櫧	fuhj
椦	fugx
栛	fxxx
楖	fxvx
榋	fxxx
桘	fydv
栬	fycb
櫭	fxvf
朹	fyfv
椂	fxkv
疌	fxnf
桾	fxql
輙	gabu
甎	gaaw
棦	fyxv
瑘	gacj
璢	gagj
椧	fyxj
楎	fygc
榠	fyjt
梚	fylq
杺	fyiv
棎	fytf
検	fyte
榓	fyqm
椆	fwhl
栍	fwgv
榝	fwfq
樧	fwfq
桸	fwsm
梉	fxhf
椶	fwxe
棴	fwxb
鐢	fwww
枂	fwyv
朻	fxgv
巭	fxgu
橪	fwsu
欎	fwwa
檭	fwvn
橳	fwux
欆	fwwb
棥	fwwf
殅	frwg
歾	frwt
殔	frxk
肂	frxa
梑	fruo
樅	frtn
椛	fser
榞	fsem
栨	fsei
﨓	fsea
榵	fsar
槈	fsac
柭	fsbo
殙	frtj
䴕	frmy
殧	frod
鵏	frou
殥	frot
梸	frmd
銐	frmw
槇	frmt
鮤	frmt
殩	frmp
樢	frov
櫸	frsa
殮	frrl
殦	frro
楰	frte
殈	frqm
棿	frqr
櫙	fsgl
櫹	fsxf
桰	ftal
椕	ftbf
檴	fswb
檧	fswy
烎	fsuo
橵	fswe
栯	fswy
櫵	fswu
槆	fswj
櫒	fswh
枔	ftov
櫯	ftrh
棯	ftoy
梒	ftol
橰	ftsd
枍	ftsk
桽	ftth
櫼	fttf
櫓	ftjr
桼	ftkv
璽	ftmo
蠒	ftmk
壐	ftmh
橮	ftmb
欟	fslm
槗	fsll
栤	fskv
櫗	fsmo
柡	fskv
欂	fsia
欌	fsgs
櫣	fsgp
橗	fsjw
棤	fsjr
柨	fsmv
櫔	fssk
楳	fssf
栭	fsrv
檋	fstg
櫪	fsrn
栫	fsnv
迃	fspd
枤	fsqv
纝	bjjb
綶	bjfv
緹	bjfn
縪	bjsa
縨	bjmh
縄	bjkd
綕	bhyi
繶	bijy
綥	bjaj
絒	biqc
緦	bjyi
緆	bjwt
纗	bjwl
紻	bkgd
絧	bkfl
紶	bhvv
緎	bglf
纉	bggm
綇	bgos
綊	bgtt
縥	bgrh
緙	bges
絚	bfwf
杘	bfvh
緁	bfxn
剭	bhmd
纈	bhlm
繨	bhup
繬	bhtl
繥	bhll
犚	bhaw
螱	bhak
癷	bhgu
鶥	bmro
絖	bmhw
縎	bmgs
繯	bmfr
緽	bmmb
彑	bmmm
縇	boff
紸	bogn
絗	bnlv
緔	bnss
紪	bnri
圅	bnud
歰	bobn
欩	blei
繢	blkm
繴	blob
刟	blmd
縜	blmb
絽	bllv
繰	bllf
繝	bkwy
彔	bkvm
巶	blck
綤	blcb
糪	blop
鼊	bloj
䴙	bloy
綛	bboy
糿	bbds
緡	bcaj
縀	bbsb
叒	bbbu
聸	aysu
抌	ayqr
捔	aytn
掵	ayxj
縔	bbbf
欼	bbbe
刕	bbbd
飝	bbbk
毲	bbbr
逫	bbbp
顙	bbbm
糽	bans
縉	bauj
綒	bevk
縘	bevg
緥	belf
纅	bevf
絥	besq
綞	besj
縚	berj
緗	bfmf
邆	bflp
絉	bfod
覴	bflm
縬	bdkm
剶	bdmd
遦	bdmp
縅	bdfc
繊	bdgk
緸	bdht
綘	bedn
絈	bebs
緱	bebq
紨	beac
屚	bdyh
緶	befw
緀	bdxc
絾	bdvi
紑	bdus
繧	bdsv
纘	bwqm
絇	bwlv
緧	bugo
緫	bwty
紭	bvvv
縿	bvvt
綼	bwdi
繍	bxpt
緵	bwxe
屫	bxel
龴	buuu
纊	bust
絋	buvv
綈	buvq
綐	bulq
絴	bugs
絣	busj
緿	bvly
紴	bvps
縃	bvnw
繅	bvjf
妑	ccbn
姄	ccai
姧	cchg
妜	cbte
隦	cblo
孎	cbkk
婽	cbsb
鴑	cbro
媁	ccin
陻	cdht
娸	cdjn
娝	cdlv
婡	cdln
嫷	ccsw
奻	ccnn
邚	ccjn
媙	cdfc
隇	cdfc
婹	cdcn
陦	cdac
繺	byxu
睯	caem
絼	byks
緷	bygc
娺	cbbb
婮	cbdg
媉	cbhk
隥	cbfu
嬵	cbem
鴖	caro
刡	camd
絬	bres
絩	bqss
絎	brah
鳲	broh
屨	brlc
綧	bovk
纃	bous
縍	bouo
纐	botm
繵	bonf
綡	boma
縞	bols
綂	bolq
遟	bopd
袰	bory
縼	boqn
紃	bqcs
縭	bpxv
緕	bpts
緍	btaj
緰	btfm
繱	bswy
絠	bswy
繜	buga
縒	bufo
絟	btgn
刔	btmd
刅	btid
絵	btsv
繌	brwe
縙	bsar
紏	bsdi
屘	brvk
縦	brun
絘	bsei
縓	bsem
緓	bskg
屒	bsnh
紎	bsqs
繿	bsqm
纄	bsep
緢	bsjt
縸	bsjg
撎	ahyu
捇	ahtt
聙	ahwy
掅	ahwy
抾	ahvv
擣	ahva
撻	ahup
摬	aijq
攈	airh
摌	aiqw
攗	aipm
搟	aghg
聀	aggr
摫	agmx
聝	aglf
摙	agpd
畱	agbj
捙	agco
丣	agbu
捓	ahcj
聐	ahlv
挃	ahko
抴	ahio
聗	agtt
摏	agrj
搸	agrh
撍	agqj
摤	agww
挗	agvg
攞	ambw
聵	alkm
拀	alqr
捛	allv
毮	amqr
摢	amqa
挸	amxo
攄	amjy
攎	amjm
挄	amhw
摣	ammi
挊	akak
捑	ajxg
掲	ajwr
擝	ajwm
撋	akgn
抰	akgd
摱	ajmb
撔	ajom
攂	ajjj
戨	alag
㧏	akwl
擻	alde
耼	aksi
掓	akmb
瓼	akkw
捚	akko
擃	akss
擈	akut
掆	akuj
搱	abox
択	abod
捤	abrm
撜	abfu
摨	abkw
撱	acsw
搮	adfv
搣	adfu
邒	acjn
讒	uylo
䏝	wsxo
釧	wqcj
鋅	woxj
鏝	wjmb
鏍	wjbs
鐃	whhh
鉑	webj
鈣	wafx
詮	utgn
鰱	tgpd
謨	usjg
訖	uqvi
諺	uiqt
詁	udga
䥽	txbo
䦃	tshj
鱸	tmjm
銓	wtgn
錳	wvmn
銖	wwti
飩	yaxg
顳	aaam
㤘	yyxl
墾	yvht
饈	yubc
飭	yqxk
奐	yktg
飪	yens
餒	yecn
牘	thmm
鱷	tgll
縑	buxt
傯	erey
驥	durt
硯	dmxh
麪	deav
嬋	clld
隴	ciwm
嫗	cgll
纜	bsqm
蕪	sqsu
紇	bqvi
締	boum
縲	bjbs
綏	becn
鷥	bbro
紂	bacs
捫	akno
㧟	aigf
櫚	fkll
璦	geye
軾	ggfo
輊	ghkc
稈	rjhg
鼴	rbgc
簍	qldc
糉	pwxe
襤	psqm
褸	pldc
齲	mqkk
貯	moan
螄	kyfm
崢	jexv
塢	hywt
壢	hsrn
琿	gygc
軋	gxic
輜	gvjt
鵪	gkro
攭	abdk
㧐	abbu
摂	aass
銴	aewj
乴	aevi
烲	aeuo
裚	aeor
扷	aeoo
擨	aeme
擟	aftw
掚	afmr
揦	aflm
揊	aflj
聴	admy
搷	admt
瓸	adjr
撠	adjg
擮	adgw
擜	adks
梊	aefv
捠	aeft
扻	aeio
挬	adyv
捳	aefj
拪	adxo
捿	adxc
拞	aefi
捀	aedn
娎	aecn
鄑	aujc
攁	augv
攍	aucn
揂	augo
拡	auvv
掶	auxt
聠	ausj
攚	auul
掋	auto
攃	aswh
聁	atbd
捪	ataj
擏	aswe
聏	asrr
耺	asvv
抎	asvv
拻	asuo
扵	atsi
攕	attf
扸	atpo
扴	atti
聡	atvy
捴	atvy
抙	atuo
抮	atto
扟	avdi
㩳	awwb
聭	awur
撨	awuo
揈	awua
揔	awty
拹	axxx
搚	axxw
挧	axxi
聉	axxg
揤	axvx
搄	ayff
揯	ayff
拁	axlv
旾	axjr
聕	awlv
擸	avnb
抁	avqr
撪	avgg
摷	avjf
乤	avik
瓩	awkw
挿	awjr
捦	awjo
撡	avvo
聫	avvg
聮	avvu
聈	avxk
攊	asrn
攠	apli
摉	aptr
搈	aptl
揬	apsq
攛	aprb
聹	aoya
聜	apfo
聺	aowh
擌	aqgt
聅	aqir
攇	aody
捾	aobb
擯	aofm
聢	aofn
聤	aoan
攌	anmr
捗	anma
攩	anne
挔	aory
摼	asbh
搑	asar
挋	asco
擹	asfe
攑	arsa
拵	asnv
擆	ashj
擛	ashf
甅	askk
擙	arpg
擶	aqum
聎	aqss
聥	aqkk
逰	aqvp
鵈	aror
瓱	armw
搩	araf
颪	arfk
硓	dhri
磽	dhhh
豣	dhhg
硈	dhlv
礂	dhll
駤	dhkm
趇	didk
勡	dhxk
驝	dhyf
霮	didx
雴	didy
硳	dhtt
駍	dhue
硣	dhvk
馯	dhgm
韯	dglf
硦	dgsj
騻	dgww
磢	dgww
驧	dgwp
騴	djoc
豱	djmn
駻	djhg
霷	djjt
靁	djjj
磮	djtn
螒	djtk
倝	djte
硶	djtv
驆	djsa
騉	djrr
硸	djsh
駲	diqc
霶	dioo
霠	ditv
霗	ditb
騿	dijd
靊	djdu
靐	djdj
𠦝	djdi
騍	djfv
磑	djfu
礲	diwm
騸	dixx
霐	divv
豟	divi
砨	divi
碋	djal
霃	diyq
麲	demx
覉	dggl
麶	depv
礉	deoe
磃	demu
礄	dell
騡	dekv
蟴	dekc
駱	delv
覄	desq
麧	deqv
碷	dedm
熭	ddxu
霋	ddxc
駙	deac
駇	dehm
馸	dejm
赼	deik
麮	dehv
駈	defi
麱	defu
碫	defq
騱	devg
硹	dftv
豧	dfus
趰	dftw
雬	dfvy
馷	dfmv
鸘	dfmr
趚	dflv
𢦏	dggi
碊	dggg
硨	dgch
碄	dffv
麭	dewc
磘	dewo
麬	devp
磤	dexq
馲	dqai
騀	dqag
砤	dqcy
趓	dqfv
䶮	dqfg
馼	dpwm
硛	dpih
駳	dqnx
硟	dqnx
趃	dqgu
豛	dqhs
騈	dqhh
驙	donf
礗	dofm
驞	dofm
豥	dois
騌	dohs
碂	dohs
靌	dogm
遤	dpdm
逨	dpdl
硡	dosv
駺	dovn
驐	dove
霽	dous
騯	douo
雿	dqss
顬	dsdm
騵	dsem
卋	dsfi
枽	dsff
硴	dser
﨣	dsdi
磶	drwu
礥	dsbm
馵	dsjm
騲	dsjd
礍	dsjx
趪	dskt
碤	dskg
桒	dsfv
尭	dshw
驠	dsfu
驊	dshs
騬	drur
駣	dqss
霺	drfq
碸	drfh
驄	drey
趏	drek
礆	drlh
趒	dqss
趀	dqxq
磫	drtn
豵	drtn
騪	drnb
孁	dllc
尵	dlkm
趮	dllf
礹	dlle
邫	dlcb
叓	dlbu
霵	dlag
礀	dkwy
駽	dlwy
龗	dllm
霣	dlmb
蜝	dkcj
畞	djyo
駧	dkfl
雵	dkgd
驨	djwl
駚	dkgd
霻	dksu
驜	dkut
駎	dkom
顣	dkmm
硱	dnfv
碠	doan
礃	dntu
磍	dodl
砋	dnih
硘	dnlv
駰	dngd
尳	dmgo
剘	dmdj
矵	dmdh
硵	dmnw
夒	dmne
夓	dmre
赻	dmqp
礋	dmhd
豠	dmis
趠	dmjd
駫	dmhw
碵	dmmb
嗭	dmlr
驉	dmkg
礭	ddwi
妦	cdnn
騭	cnmd
姲	cocn
韣	cmwk
婋	cmun
娊	cmxn
媫	cmxn
隚	cnht
嫼	cnen
婟	cndg
婝	cofn
婛	coma
埅	coht
婃	cohs
嬠	cllf
孍	clle
巼	clri
妕	clns
媀	ckyn
阥	ckvj
婔	clin
陫	clij
姯	cmhw
隲	cmqd
嬽	cmng
娯	clxt
嬕	cmhd
隵	cmfg
矡	cqmb
鷸	cqkr
劀	cqkm
姂	cqpe
妷	cqgu
阣	cqvi
孂	cqvm
阩	cqsj
陹	cqsj
隣	cpra
韕	covk
嫎	couo
嬣	coya
媯	coww
熃	cqeu
鶩	cqer
騖	cqed
暓	cqej
敄	cqeh
奦	cqeg
鞪	cqeg
娻	cfjr
螴	cfjk
敶	cfje
陚	cfgn
韚	cgei
陭	cgal
陓	cgfs
媋	cgjr
隁	cgjc
塦	cght
嫥	cgac
媡	cfnu
阷	cfni
姃	cfni
姉	cfmv
陘	cfvf
陠	cfuj
嬭	cftw
檃	ceff
姙	ceen
隫	cdsm
嫴	cdox
隭	cdsr
媅	cdxi
妚	cdun
娐	cevk
嬓	ceoe
嫍	cerj
娷	cesj
娦	ceft
韟	cegd
婇	cefv
妡	cejn
韞	cjmn
婩	cjsh
韠	cjsa
婫	cjrr
媣	ciyf
隡	ciqw
隑	cjfu
嬍	cjfe
奾	cjsn
孄	ckfu
姛	ckfl
妽	cken
媏	cjsr
媤	cjyi
嬑	cijy
韢	cgyi
韘	chfv
嫊	chbs
嫤	cgsi
隞	chwe
隯	chva
嬦	chva
嬂	cijg
媇	cifv
嬄	chyu
韥	chmm
嫧	chmb
媴	chlr
嬯	chlh
媎	chjr
韎	choi
嬙	chtl
婈	chte
隉	crfo
霯	dbfu
騤	dbfg
駅	dbod
碿	dbmw
騢	dbsb
豭	dbsb
砪	dbmh
騛	dbkm
蛪	dbkc
駋	dblv
洯	dbkv
砙	dawh
瓳	dawg
媈	cygc
韐	cyei
嫓	cykr
陥	cynj
媍	cymb
婏	cylo
娽	cxkv
嬧	cxfm
嬥	cxxw
駵	dagb
隖	cywj
険	cyte
妼	cyqp
嬆	cyxx
碬	dbsb
磹	ddjd
雼	ddhy
驦	ddfm
磦	ddhs
豩	ddss
礝	ddsr
豮	ddsk
硥	ddto
騳	ddmm
顂	ddmb
駀	ddom
觢	dbyt
郲	dcjl
硧	dbtn
赽	dbte
攳	dbxa
驏	dbvv
驋	dbvq
駶	dbvl
馶	ddbu
嫑	ddcn
驫	dddm
霱	dcql
騥	dcqf
娂	csti
姏	cssi
嬳	cswb
韤	csmo
孏	csku
嫹	cskt
韛	csqt
嬞	cswk
媹	ctjt
嬶	ctja
隂	ctha
姾	ctgn
娢	ctol
陯	ctfn
姷	cswy
婨	ctfn
嬒	ctfj
妢	ctbd
嬩	crst
媘	crre
姼	crrk
韍	csbo
妭	csbo
媶	csar
媷	csac
姳	crlv
﨩	crjs
姀	crhn
婾	crfv
隝	croj
娾	cshh
陾	csgd
媆	csgd
媠	csfw
隓	csff
嶞	csfj
嫨	csfg
陖	cvte
阭	cvqr
姢	cvwy
娹	cvov
孇	cwwb
嫶	cwuo
陎	cwti
媰	cwxx
婎	cwin
陮	cwij
媑	cwkk
陱	cwpm
婅	cwpm
嬘	cudp
鐆	cudw
嫅	cufo
媨	cugo
媄	cugd
妎	ctti
妐	ctvv
娮	cuan
婣	ctxf
嬼	ctwm
隒	cuxt
嫝	cuxk
媊	cuwm
嬨	cuvy
阦	cuoj
婒	cuuo
嫸	cuul
嬫	cuuf
嫬	cusu
蚥	ktwl
誾	kuan
蜵	ktxf
蠩	kuhj
闂	kugv
菐	kugu
黺	kumb
閲	kulq
糳	kudp
蜦	ktfn
仧	ktes
閄	kten
蛕	kswy
蚳	ktao
閽	ktaj
螑	ktsq
䦟	ktth
閝	ktob
鹷	ktob
蛿	ktol
蠄	ktpv
鹶	ktov
蚙	ktov
罓	kwlf
蝩	kwkk
覵	kwmx
鷳	kwro
虳	kwod
畃	kwod
蚒	kwob
蜔	kwjt
蚫	kwck
閵	kwin
﨡	kwgc
羀	kwwj
蠑	kuuf
鸈	kutr
螊	kuxt
蝷	kuux
焛	kuon
螠	kutm
蟅	kusu
鹻	kuxt
彂	kvqi
闗	kvvu
蟣	kvvt
闞	kvae
蜬	kvkx
觃	kvkx
虸	kvkc
蜶	kotd
閌	koqj
蜳	kovk
螪	koul
閙	komv
蝊	kofn
蝖	koff
螛	kodl
蚄	kogc
閍	kogn
蠰	kolr
閬	kovn
虴	kqai
蛈	kqgu
螏	kpqi
蜟	kovw
迧	kpde
虲	kmoc
泴	kmnv
蠷	kmmw
蛅	kmlv
蠳	kmmc
闅	kmmb
蠉	kmfr
螖	kmgc
蠦	kmjm
蠌	kmhd
蜆	kmxc
蜠	knrh
蟔	knec
蜖	knns
閫	knfv
闛	knht
蟈	kngf
蝧	kskg
冔	ksla
蠇	ksky
螮	ksfm
豑	ksfq
蠴	ksmj
蟵	ksfa
敟	kste
闀	kstc
閎	ksvv
蚅	ksvi
闏	krfn
蟍	krmf
閁	kqpn
蛌	kquc
蟱	kqsu
閐	krmn
蝆	ksao
蛂	ksbo
螕	krwr
蠀	ksem
頮	ksdm
颒	ksdk
閗	ksdi
蝔	krre
蛥	krrk
蜌	krrh
巀	jmwg
咞	lfsj
噆	lgqj
噖	lggv
喖	lfdg
哹	levk
嚛	levf
焁	leuo
啢	lfmr
囇	lfki
啱	ljdh
喅	ljid
呥	lkht
嘊	ljsh
嚋	lhva
呭	lhiv
嘵	lhhh
嘋	lhve
嚫	lifm
啨	lhwy
蝬	kwxe
咓	lawv
唞	lasd
咠	larv
噝	lbbs
啹	lbdg
蠗	kxxw
蛡	kxxi
翈	kxxi
蟰	kxtf
䦛	kyxv
蜭	kyrj
鹸	kyte
蛫	kysv
啿	ldxi
唕	ledi
哸	lecn
啚	ldnl
嗁	lemu
喒	lemj
呚	lehv
唨	lcmi
甊	ldla
咟	ldjr
嘾	ldjd
嚖	lddy
嘜	ldeh
錖	kmbw
裻	kmbr
嵡	jtvx
曍	jtsd
昣	jtto
畍	jtti
嵳	jufo
嶸	juuf
巙	jute
崷	jugo
畻	jugh
嵄	jugd
嶟	juga
曔	jswe
嵟	jswi
岻	jtao
嶥	jsue
嶡	jsue
峜	jtni
嵢	jtol
昑	jtov
嵧	jtjt
畭	jtff
暞	jtfv
崘	jtfn
甠	jwgr
晭	jwhl
崯	jwjs
崥	jwdi
鶍	jwtr
焽	jwuo
敡	jwtb
猒	jwsq
崡	jvkx
崰	jvjt
屷	jvjs
嵹	jvlk
昿	juvv
晜	juvq
嵻	juxk
巕	juyc
嵾	jvvt
歞	jvve
岋	jvod
曊	jvtm
岪	jvti
嵶	jvss
辿	jpds
昗	joti
畩	jory
崹	joum
嵭	jouo
岤	jpxs
嵱	jptl
畮	jqbm
峩	jqag
曭	jnne
峖	jocn
峴	jmxs
崓	jndg
嵪	jols
暆	joqc
曢	jogm
晥	jofh
昘	jogr
峕	jojr
畡	joit
晐	joir
屵	jshs
嶏	jsgb
亗	jsis
暯	jsjg
嶆	jsjj
嵽	jsfm
曂	jskt
疂	jssm
鷐	jsro
盢	jsmn
鷝	jsar
崻	jrha
峲	jrmd
嶮	jrls
崣	jrcn
曻	jrao
嵸	jrtn
鴫	jrot
嶌	jros
暀	jrog
蝳	khbm
螼	kgsi
閾	kglf
蝘	kgjc
蝒	kgic
闚	kgmx
蚟	kgnc
蠮	kgqx
閠	kgod
螧	khrj
蟽	khup
蟯	khhh
閈	khgn
闧	khlp
蝫	khjr
螎	kfln
戙	kflg
朄	kfnu
蜽	kfmr
閸	kfja
蛃	kfkt
閳	kgcn
蚷	kgbu
蜯	kgao
螹	kgej
蚈	kfsj
蛚	kfrm
蛵	kfvf
蚞	kfvc
蜐	khvx
闦	kksu
蚦	kksi
蚛	klns
蛽	kmbc
閖	kkvn
蝄	kkuu
濷	kisr
蝋	kiqa
閯	kimq
蠬	kiwm
闙	kile
螰	kilc
閚	kidn
䞍	khwy
蟙	kijg
蟝	kigf
閊	kjsn
鷼	kjro
閺	kjpw
閶	kjjr
蟃	kjmb
蝿	kjkd
嶭	jyox
嶖	jyxx
嵨	jyws
嶑	jyld
畂	jyod
虭	kbdc
蝝	kbds
畁	kajo
閇	kakn
閅	kann
閜	kalv
蟶	kalg
曃	jxkp
嵏	jwxe
峍	jxao
岄	jwys
峆	jyes
昢	jxxg
曓	jxxf
蟘	kegm
蚘	kdoc
閪	kdxn
蟡	keww
螇	kevg
蛜	kexq
閿	keyb
虶	kfau
閆	kfan
蛒	kelv
闎	kekv
蚚	kejc
蚸	keod
螩	kenf
螔	kemu
蝞	kbmf
蠾	kbkk
蚗	kbte
蛨	kdjr
沯	kdhv
蠘	kdgw
沀	kcuv
蚽	kdfi
蝛	kdfc
蟖	kdej
闄	kdcn
覞	mmxx
鑍	mmwj
虤	mmuu
戵	mmwg
贘	mnmb
欳	mnei
瞁	mmsq
虘	mmiu
贙	mmmb
尛	mmma
贁	mmeh
鸎	mmro
鷶	mmro
奰	mmmg
盀	mmno
䁖	mpcn
髍	mpag
矃	moya
齩	motw
賋	motw
䲣	mqeh
睋	mqag
髕	mofm
睻	moff
幥	mntu
貥	moqj
帵	morv
賅	moib
賩	mohs
罜	mogn
瞚	moft
髇	molg
睤	mjaj
罿	mikk
罯	mijr
齴	miqt
睅	mjhg
眎	mhsf
尡	mhjr
瞦	mhll
幘	mhmb
齖	mhyc
䝼	mhwy
帹	micn
齭	miej
幬	mhva
睈	mlgn
眖	mlqr
貺	mlqr
覘	mlmx
贃	mlly
瞣	mlly
賗	mlln
幧	mllf
頕	mldm
梷	mlbf
賏	mmbb
刞	mmdi
齞	mlti
睊	mlwy
瞨	mkug
勴	mjyx
幆	mjwx
睓	mkst
賵	mksm
齥	mkqp
瞤	mkgn
戯	mkgg
劅	mwkm
揱	mwmt
矄	mwne
賯	mwjv
齙	mwck
蠽	mwgk
雐	mwiu
覐	mwwl
睷	mxax
齺	mwxx
虝	mwto
瞊	muxl
賧	muuo
賹	mutm
罤	muvq
虍	muuu
貱	mvpb
罺	mvjf
覎	mvkx
齝	mvlv
髉	mywi
肻	mywy
踙	nabu
咼	naa
賝	mytf
敹	myqe
郻	mxvc
戱	mxfg
齓	mxic
賱	mygc
睴	mygc
齳	mygc
賿	mxxt
矁	mruy
瞛	mrtn
齯	mrqr
瞗	mrof
瞙	msjg
幭	msmo
贎	msky
郹	mscj
瞸	mshf
毟	mqrm
幠	mqsu
盵	mqvi
瞴	mqsu
賉	mqmn
齚	mqmo
齔	mric
覹	mrfq
矀	mrfq
眳	mrlv
齨	mrjc
幯	mqxx
瞈	mtvx
矏	mtpo
齘	mtti
睉	mtth
羉	mubb
瞓	muqc
賆	musj
賘	muho
眻	mugf
罖	mtod
矆	mswb
眃	msvv
帪	msnv
贆	msss
睰	mssl
賒	mths
眡	mtao
貾	mtao
䴗	msya
䱷	mteh
睔	mtfn
瞺	mtfj
唲	lrqr
哛	lrtb
咊	lrhv
噞	lrlv
嘥	lrnn
靟	lrmi
啝	lrlv
唀	lrvj
嗕	lsac
囄	lpxw
吘	lqdi
㘎	lpve
嘸	lqsu
哘	lrah
噃	lqpj
嚠	ltwm
嗿	ltom
嚝	lust
哾	lulq
嚂	lsqm
猆	lsqi
囆	lskk
嚦	lsrn
哶	lshg
嚈	lsjs
噲	ltfj
嘦	ltdc
噾	lpij
鄵	lllc
劋	lllm
喿	lllf
嘂	llxl
鄖	lmcj
丳	llti
㖞	llkt
嚪	lkyr
嚻	lldl
郘	llcj
㘚	lkve
嚉	lkua
唺	lkst
囅	lljg
嘼	lljl
鄲	lljc
辴	lljs
鷤	lljr
遌	llfp
覨	llfm
卾	llfx
嚌	lous
囃	lotw
唹	lots
囎	lmuj
鶰	lmro
囐	lmfs
嘪	lmmb
呬	lnqr
噛	lnpx
迚	lnpd
哯	lmxv
噦	lndm
虪	menn
齗	mejc
骵	mffi
齽	mffh
罧	mffv
虨	mfft
骬	mfau
罦	mevk
賻	mfac
幁	mdmb
顝	mdmb
幖	mdhs
帺	mdjv
贉	mdjd
骽	mecn
虗	mefi
帿	mebq
豦	mdsu
勮	mdxk
瞘	mgll
賰	mgjr
睶	mgjr
虥	mggg
盰	mhgf
幉	mhfv
齛	mhic
韑	mhci
骮	mgyg
帴	mggg
盶	mfhw
幊	mfmb
賕	mfko
貦	mfhw
齾	mflm
呁	lwsi
哠	lwlv
剈	lwmd
吀	lwkv
嚑	lwne
鷕	lwro
哅	lwwx
肙	lwyv
噚	lxfa
呞	lvfl
吇	lvkv
唴	luxi
嘃	luxw
瓹	lwaw
羄	mbmj
羂	mblw
罻	mbha
眧	mblv
齠	mblv
瞲	mcql
郥	mcjb
幃	mciv
貤	mcyb
嗋	lxxw
餥	lysi
嘝	lytd
帄	manv
眲	marf
罬	mbbb
齱	mabu
𡭔	maaa
祣	hqry
圥	hqrt
垁	hqit
塲	hqjt
殻	hqjf
垗	hqss
堸	hrft
垀	hqua
墲	hqsu
垳	hrah
埌	hovn
塝	houo
鬡	hoya
垶	hoxt
圫	hqai
坹	hpxt
镻	hqgu
祑	hqgu
埪	hpfo
迣	hpdi
塎	hptl
堗	hpsq
禷	hpsm
壦	hslw
祳	hsns
髵	hsra
墴	hskt
塻	hsjg
鬕	hsjg
墷	hshs
墸	hshj
坋	htbd
坁	htai
夌	hteh
垬	hsti
塃	hsuq
堦	hrre
墺	hrpg
垑	hrrk
鬁	hrmd
塡	hrmt
鳱	hrog
埖	hser
鬗	hsfr
堶	hsfw
鬌	hsfw
圦	hrut
塖	hrur
坺	hsbo
歖	hlue
壴	hlue
祌	hlns
皷	hluv
蟚	hluk
鼜	hluk
鼞	hluh
壧	hlle
圵	hkst
鬞	hkss
墹	hkjr
塷	hklt
埛	hktl
祦	hlfg
壝	hlkp
墤	hlkm
堈	hkuj
鬜	hkwy
堣	hkyt
壛	hkyr
壋	hnjt
祵	hnfv
勩	hmxk
堝	hnat
垷	hmxt
塇	hoff
禞	hols
鬤	holr
坾	hoan
垨	hoac
圡	hodt
垻	hmbt
貰	hmbi
壉	hmds
翓	hlxx
埍	hlwy
皾	hmmv
覿	hmmm
夁	hmnd
坥	hmit
垙	hmhw
壚	hmjm
壭	hxjf
礼	hxis
凷	hxgt
䴖	hwya
堫	hwxe
埐	hxyb
垥	hyet
垖	hydt
逺	hxrp
鴄	hxro
堹	hwkk
靗	hwmh
坸	hwlv
嗸	hwel
嶅	hwej
摮	hwet
圽	hwto
兀	hwww
禶	hwqm
圴	hwod
礿	hwod
靔	hwqq
靝	hwqp
澑	iagj
滒	iall
鬇	hyxv
埩	hyxv
灄	iaaa
竳	ibfu
湀	ibfg
涺	ibdg
潳	ibhj
淥	ibkv
灟	ibkk
湁	iaye
禈	hygc
堚	hygc
亄	hyfx
塓	hyjt
髧	hyqr
坈	hyqj
塠	hypd
祪	hysv
墖	hyjt
壷	hylf
镹	hyod
嫯	hwec
塕	htvx
壪	hubv
耂	httt
慹	hudy
壿	huga
禉	hugo
堘	hugh
漐	hudk
蟄	hudk
贄	hudm
褺	hudr
瓡	hudq
禭	hudp
﨏	httl
勎	hthx
坴	htht
燅	hthu
塯	htjt
鼀	htjm
堬	htfm
鬠	htfj
暬	hthj
驇	hthd
圿	htti
坽	htob
坅	htov
迲	hvpd
髲	hvpa
鼁	hvjm
坮	hvlv
唟	hvlr
叝	hvxb
墋	hvvt
郬	hwcj
塮	hwac
堖	hvrw
禙	hurw
塧	hutm
鬀	huvq
埮	huuo
祱	hulq
赱	huod
垜	hvfv
翿	hvfx
魗	hvfw
璶	gxfm
酦	gxbo
匩	gxgn
匨	gxhf
玏	gxkn
玌	gxin
輣	gwwy
奟	gwwy
珒	gxao
珕	gxxx
璻	gxxd
珨	gyen
輑	gxql
蟿	gxqk
檕	gxqf
礊	gxqd
琕	gwdi
軳	gwck
珄	gwgn
隿	gwiy
醀	gwio
奞	gwid
奝	gwhl
輖	gwhl
厺	gvvd
酳	gvwy
醦	gvvt
璣	gvvt
璳	gwtm
珗	gwqr
鴎	gwro
輷	gwua
璡	gwpd
珤	gwon
玬	gwob
墛	hbha
壀	hblo
繛	hbmj
祒	hblv
墱	hbfu
堟	hbds
毊	hbql
漀	hbqk
殸	hbqh
匛	gyod
輡	gyrj
璭	gygp
珎	gyma
圢	hant
瓺	hawa
奅	gtmd
軡	gtov
玪	gtov
靲	gtov
酫	gtgn
輇	gtgn
鵊	gttr
輍	gttl
玜	gtvv
軣	gssi
玵	gssi
瓑	gsrn
輁	gsti
珔	gsnv
璼	gsqm
轞	gsqm
酭	gswy
奃	gtao
軧	gtao
琘	gtaj
夽	gsvv
軛	gsvi
瓁	gswb
匶	gswr
琷	guxi
輺	gvfj
軐	gvdi
醈	guuo
𡗗	guuu
匥	gvsj
輽	gvgj
轈	gvjf
軩	gvlv
羍	gugd
琂	guan
轙	guqg
尞	gujm
鷯	gujr
刾	gumd
堯	hhhh
顤	hhhm
壵	hhhf
髰	hhia
堼	hhah
鞤	hhag
堎	hhte
郌	hhlc
臸	hhkk
祮	hhlv
愨	hfyi
镾	hftw
埉	hgtt
祴	hgsj
镽	hgum
堾	hgjr
塸	hgll
堒	hjrr
堓	hjsh
垾	hjhg
塒	hjha
堁	hjfv
塏	hjfu
禗	hjyi
堨	hjwx
鬄	hjwt
埁	hjtv
墔	hjwi
乽	hjvi
煑	hjuo
禓	hjft
墇	hijd
隷	hhxk
壔	hhva
劸	hhxk
奊	hhxg
埥	hhwy
斱	hjej
壜	hjdv
髿	himq
塶	hilt
壠	hiwm
墭	hdvm
埓	heac
坿	heac
攼	hehg
堭	hegn
麺	hegi
塳	hedp
埄	hedn
垊	hcai
逇	hcpd
墢	hbvq
墂	hdhs
墰	hdjd
墄	hdkm
墘	hdjv
塛	hdfv
髬	hdfi
龶	hfff
埡	hfja
髨	hfhw
坃	hfhw
坘	hfbm
堜	hfnu
墕	hfnu
嗀	hflv
嗀	hflv
堛	hflj
墽	heoe
堢	helf
臵	helv
垎	helv
墧	hell
孷	hesv
塪	herj
垘	hesq
漽	ibkw
溾	iwus
淗	iwpm
汼	iwns
鵳	iwro
鍌	iwqw
泤	ixot
瀷	ixxt
瀥	ixxo
瀈	ixxg
湕	ixax
堻	ixah
濜	ixfm
氻	ixks
澅	ixhf
讋	iwmu
錃	ivwj
顅	iwdm
驡	iwmd
竧	iwmd
鸗	iwmr
龖	iwmm
潗	iwfv
旫	jbdr
岹	jblv
曯	jbkk
岃	jbod
朂	jaxk
嶊	jawi
鄳	jcjm
妟	jcnr
邖	jcjs
崫	jbxx
甼	jant
沵	iyma
潒	iyld
蛍	iykc
汣	iyod
峃	iyjs
鴬	iyro
溮	iyfm
竫	iyxv
嵿	jadm
湌	iyss
溩	iyws
敩	iyve
灆	issm
鍙	istw
汫	isti
湈	issf
瀶	isql
竕	itbd
漵	itfe
潊	itfb
汄	ites
汯	isvv
濍	iswy
渜	isgd
懘	isfy
懣	isfy
澬	isem
浱	isns
滣	islv
瀎	ismo
麎	isnl
竎	isjd
瀳	isiu
汅	isks
竰	iskk
渶	iskg
渵	isjt
澮	itfj
濚	iuuf
瀇	iust
渆	iusm
澇	iuux
溔	iuuo
瀅	iuuo
瀯	iuul
潎	iume
洆	ivkf
汓	ivks
灉	ivlw
漮	iuxk
濨	iuvy
溬	iuxv
湽	ivfj
滽	iuxw
沜	itps
瀸	ittf
涻	ithl
竛	itob
淃	iugv
湭	iugo
潫	iugb
涚	iulq
竲	iujj
潧	iujj
溠	iufo
鼝	itxb
洕	itwy
暟	jjfu
嵔	jjgf
嵦	jjfu
畼	jjft
崼	jjfn
嵜	jilv
﨑	jilv
嵃	jiqt
嵼	jiqw
晿	jjjr
曡	jjjm
曟	jjjs
曑	jjjt
晘	jjhg
疉	jjjb
櫐	jjjf
壨	jjjh
峌	jhks
峔	jhri
晆	jhht
嶤	jhhh
嶢	jhhh
崶	jhha
岦	jids
昈	jier
崝	jhwy
岼	jhue
圼	jhtr
嶹	jhva
暺	jlld
岲	jlqr
嶉	jlwi
汖	jkvs
曗	jkut
嶫	jkut
嶪	jkut
暃	jlir
嶁	jldc
岾	jmlv
嶵	jmli
曥	jmjm
嶧	jmhd
畕	jjtt
屾	jjss
焸	jjuo
暥	jjoc
昍	jjrr
峀	jkos
晪	jkst
嶩	jkss
崉	jkjr
畘	jkht
岟	jkgd
峝	jkfl
嶠	jell
岓	jejs
欥	jeir
峉	jelv
峳	jene
峈	jelv
岴	jefi
嵈	jehb
崲	jegn
嶾	jefy
峿	jfcl
峂	jesi
崜	jesj
暚	jewo
嵠	jevg
岅	jebu
嶻	jdgw
嶀	jdfs
曋	jdjd
旪	jdir
嵅	jdfl
岯	jdfi
豒	jddq
豓	jddm
晠	jdvi
峸	jdvi
嶿	jdsr
暊	jdmb
崍	jdls
嵮	jdmt
崨	jfxn
昮	jfxk
逿	jfwp
旲	jgdr
嶜	jgqj
峓	jgvg
畉	jgut
嶚	jgum
輋	jggc
嶃	jgej
峚	jght
崬	jfjr
崠	jfjr
剴	jflm
曧	jflk
敳	jfle
敱	jflb
晽	jffv
崊	jffv
嶘	jfgg
疅	jfjf
鴠	jfro
嵀	jfog
峢	jfrm
屸	jfos
颽	jflr
瀭	igtm
泧	igxi
漺	igww
滙	igwi
㳠	igpd
啔	iglv
潓	igyi
溒	ihlr
溸	ihbs
瀔	ihfr
濲	ihff
涇	ifvf
漹	ifnu
濽	iggm
潖	iggc
淢	iglf
湷	igjr
淎	igao
魙	igew
壍	igeh
嬱	igec
汏	igds
洘	ihsk
韼	ijep
韴	ijfm
灧	ijdc
竷	ijee
韸	ijed
澠	ijms
澷	ijmo
戠	ijgg
潉	ijjr
戅	ijfy
淉	ijfv
涆	ijhg
淐	ijjr
灅	ijjh
濐	ijhj
沶	ihss
涜	ihyq
淁	iicn
汢	ihts
濇	ihtl
澾	ihup
漖	ihve
澵	iife
淭	iifv
滻	iiqw
湇	iiwy
瀧	iiwm
灨	iijm
滰	iijq
滬	iilc
澺	iijy
暜	iijr
湆	iijr
泟	ifni
濣	idjd
竡	idjr
竍	idid
沰	idhs
麢	idll
湏	idmb
淶	idls
麜	idfv
麙	idfl
瀮	idff
澸	idfy
瀻	idgt
渽	idgl
瀐	idgf
洡	idti
浝	idto
淔	idmi
泋	idsj
潥	idpm
沋	idos
溊	ibsb
麚	ibsb
慂	ibty
泦	ibyf
濰	ibwi
浘	ibrm
埿	ibrh
汿	icus
焈	icuo
湱	iddh
濝	idbs
戺	icke
濻	iclm
湐	ifeb
盓	ifam
泍	iffi
漜	iffh
潹	ifff
乺	ievi
濼	ievf
潙	ieww
澔	iewl
濋	iffn
竵	ifln
溂	iflm
瀨	iflm
瀜	iflk
浗	ifko
浢	iflu
沞	ifmv
麠	ifjf
浌	iegg
滜	iegd
濦	iefy
湰	iefw
垽	ieht
峾	iejs
沠	ieks
漨	iedp
汳	iebu
泭	ieac
洉	iefl
沎	ieri
溣	ietn
漑	ierq
湺	ielf
漞	iemx
涥	iovl
渷	iotq
滧	iote
麡	ious
溛	ipqu
滵	ioyj
澝	ioyt
灖	ipli
潌	iphk
竤	iosv
滱	iofb
瀗	iody
乼	iogv
濵	iobm
涋	iosq
漃	iokb
湤	ioqc
竩	iomi
扄	irne
竓	irmd
濥	irot
淣	irqr
瀩	irqm
澓	irqe
澚	irps
渢	irfs
湼	irfo
漗	irey
潃	irew
麘	irjr
渮	isal
灚	irwm
洍	iscs
溗	irur
渪	iqkk
澛	iqjr
潪	iqlj
潨	iqms
泎	iqmo
汻	iqdi
塰	iqbh
瀿	iqbb
鼡	iqao
湚	iqvw
滐	iraf
瀄	iqxx
泲	iqxq
潷	iqxa
泘	iqua
瀊	iqqm
滊	iqpm
洀	iqos
遃	iqtp
竔	iqsj
灛	ikld
涄	iksk
潣	ikpw
渁	ikkv
澖	ikfv
灎	iksm
渱	ikfo
漊	ildc
湒	ilar
湡	ikys
塣	ilgh
洖	ilfg
麌	ilfg
灇	ikub
濧	ikua
灍	ikue
勭	ikxk
溭	ijte
湠	ijsu
潩	ijst
灦	ijvm
潂	ijuk
畄	ijts
沺	ijts
遧	ijpd
澋	ijom
灝	ijom
韺	ijsg
鶕	ijro
灁	ikek
澯	imrp
瀱	imsm
滮	imto
帍	imve
乷	imqv
竗	imqp
桬	imqf
瀴	immc
灙	inne
澢	injt
濹	inht
甂	inaw
潿	inci
漍	ingf
涃	infv
騗	indm
咅	ilvd
麣	ille
瀢	ilkp
澏	illj
湂	ills
勏	ilxk
瀘	imjm
竨	imjd
麆	imil
濖	imhj
瀃	imjt
溑	immb
湞	immb
惉	imly
扂	imlv
潈	imds
潀	imet
