的	e
一	f
了	v
是	j
不	d
我	q
在	s
人	t
有	sw
这	p
他	ec
来	fp
个	tn
你	ey
说	ou
上	k
到	h
就	om
着	u
大	g
们	ep
道	ut
那	va
么	qv
也	cy
地	hc
子	vk
下	ak
出	x
时	ja
看	tm
要	dc
她	cc
中	l
没	i
然	w
里	kk
为	o
过	ap
自	tk
好	c
得	r
去	hv
可	a
会	ts
天	fg
还	dp
心	y
后	ef
以	xo
小	m
都	hj
和	rl
对	b
想	fm
能	vw
起	db
之	pe
手	tu
而	sr
只	lt
生	wg
什	edi
身	wm
头	sg
样	fu
事	al
多	rr
己	bj
家	od
面	gi
知	ql
开	fs
如	cl
无	fd
现	gk
很	rv
点	ml
前	uw
发	xb
经	vb
情	yh
把	ac
老	hr
些	nr
话	or
已	bi
又	bu
声	hb
意	ij
于	fa
回	n
笑	qe
所	ie
但	ej
眼	mv
成	dv
方	og
年	qa
见	kx
当	mx
女	cn
真	dm
两	fk
力	xk
气	qq
从	tt
长	th
动	sv
间	pj
国	ng
走	dk
让	ok
被	pv
给	vy
正	fn
问	pl
打	aa
明	jw
儿	qr
法	ih
才	aq
几	qj
行	ra
定	of
此	nri
进	st
再	fkh
种	rln
将	ur
实	os
同	kf
最	jab
本	ff
向	rn
分	tb
十	di
学	iy
高	ol
第	qvn
感	df
怎	qm
神	hk
听	le
边	xp
作	eq
其	dj
吧	lc
口	lv
啊	lca
因	ngd
次	se
军	yhc
做	ed
外	rm
门	pn
光	mh
风	qw
主	ogn
住	eo
果	jfv
与	sf
全	tg
二	si
候	en
公	tv
相	fmf
吗	lx
等	qh
别	lxm
色	yc
死	fr
张	vt
部	il
太	go
日	jr
少	mq
战	mlg
理	gkk
直	dmi
重	wk
王	gn
像	eyl
脸	wt
比	rri
快	yb
何	ea
水	kv
名	rlv
体	eff
呢	lb
东	am
叫	lxg
西	dx
应	ui
便	efj
放	oe
马	xm
难	bw
轻	hbf
更	fj
美	ug
位	ei
关	ugd
机	fq
接	ai
先	wq
文	pw
处	em
并	us
望	uwg
常	nm
四	nq
飞	vs
师	uf
者	hjr
安	oc
清	ihw
刚	kw
跟	nv
月	wy
信	eu
山	js
爱	eys
内	kt
龙	dq
空	pf
带	sy
找	ag
入	ru
李	fv
连	hp
吃	lq
场	hvt
平	hu
思	jy
林	ffv
变	pb
由	ko
受	eyb
亲	if
命	yx
目	mf
强	vl
男	jx
任	ee
该	oo
路	ne
今	to
海	iqb
加	xl
远	fh
活	ir
特	wh
解	yt
电	kd
世	hi
性	yw
表	hry
许	oq
它	ori
立	id
金	wj
红	vf
花	ser
转	hs
总	ul
算	qms
城	hd
队	ct
孩	vo
反	eb
工	fo
始	cv
满	is
新	ife
兵	eft
物	ww
离	px
非	li
虽	lkc
云	svv
似	ex
万	fw
干	hg
通	bt
认	ot
失	qg
火	uo
士	hf
五	fc
惊	yo
魔	pwu
竟	ijq
姐	cm
乎	qu
剑	tfi
往	ro
量	jf
早	jd
结	vh
怕	yeb
流	io
突	ps
坐	tth
斯	de
音	ijr
紧	nb
指	ar
拉	aid
杀	wf
半	ua
记	ob
且	mi
利	rmd
合	ye
倒	eh
书	vv
度	usf
微	rf
步	nma
教	hve
喜	dlv
越	dg
影	jo
谁	ow
冷	sto
深	iyt
告	wl
象	yld
容	pt
怪	ybh
传	es
钱	tf
提	aj
随	cs
每	qb
双	bb
服	wx
击	ax
哪	lva
数	pc
站	im
奇	ga
管	qo
灵	xu
刻	omd
题	jfn
衣	ory
静	hw
伤	eqx
百	djr
拿	ytu
妈	cx
办	xt
星	jwg
化	er
功	fx
绝	vyc
系	qbs
般	qqh
必	yq
业	kg
尔	ym
件	ew
血	qmn
代	eg
精	ph
弟	uv
终	ve
近	epd
条	efv
青	hwy
界	jt
司	vfl
整	fl
欢	be
字	ov
晚	jyl
民	ca
帮	dcm
切	ab
即	xv
忙	yu
或	gl
暗	ji
夫	gu
员	lk
根	fvn
石	dh
哈	ly
夜	oer
父	tw
制	wkm
友	sb
阿	cal
息	ty
冲	sl
酒	ig
保	el
片	tp
形	fst
阵	ch
南	dku
决	sbt
请	oh
各	elv
报	axb
兴	it
阳	cj
急	yxy
语	ofc
令	tob
错	tsj
及	vod
刘	pmd
极	fvo
识	olt
备	ejt
慢	yj
雪	dxl
苦	sd
若	ss
收	xe
底	uta
尽	bo
准	swi
华	erd
答	qy
众	ttt
消	imw
视	hkx
罗	mr
敢	vae
留	tj
克	dqr
乐	tma
够	wlr
跑	nw
显	jk
嘴	ln
断	pxe
未	he
势	ay
句	wlv
计	odi
论	otr
达	gp
则	km
害	odl
八	ti
单	uj
久	yod
脚	whv
德	rd
元	fhw
脑	wp
雨	dy
睛	mhw
响	lr
刀	bd
确	dyt
玉	god
沉	iyq
北	uri
格	fe
停	eoa
陈	cam
市	omv
朝	djw
喝	lj
族	oqq
江	ifo
团	na
母	bm
章	ijd
装	uh
亮	oqj
客	oel
照	jb
乱	rx
依	eor
黄	sk
修	ene
破	dvp
台	vlv
球	gf
呀	lh
送	ugp
包	wc
义	owl
诉	oeo
攻	feh
丝	vvf
围	nav
玩	gfh
待	rh
复	qje
况	slq
楼	fpc
痛	pbt
梦	ffr
摇	ae
期	dw
英	skg
低	et
帝	ouy
兄	lqr
背	urw
持	ah
爷	twx
皇	egn
六	oti
穿	phy
杨	fvt
政	fne
运	svp
居	bdg
叶	ld
校	fot
谢	owa
曾	uju
细	vj
产	iq
睡	mws
希	ws
速	flp
室	ohk
另	lxk
怀	yd
露	dn
异	csj
写	ys
鬼	wu
娘	cov
取	abu
式	gfo
除	ctf
级	vvo
考	hsk
建	xa
愿	sem
招	abl
饭	re
布	sm
续	vd
程	rlg
首	utk
观	bk
朋	wwy
务	exk
掉	amj
赶	dhg
忽	wty
注	iog
术	fod
甚	dxi
差	ufo
呵	la
展	bs
品	ll
兰	usi
宝	ogo
香	rj
斗	sdi
故	deh
雷	djt
段	efq
顿	axd
角	ytn
疑	rq
护	aie
闪	pte
需	ds
调	owh
类	pg
妹	che
爸	twc
线	vfg
左	sfo
派	ier
谈	ouu
冰	skv
敌	reh
跳	nqs
支	dbu
约	vwo
您	eym
顾	svd
肯	nwy
醒	gj
铁	tq
抱	aw
淡	iu
造	wlp
伙	euo
资	sek
群	xq
集	wfv
联	au
号	ls
节	sx
掌	nt
赵	dwl
密	oy
九	yf
病	pfk
卫	xf
米	pm
威	dfc
继	vp
渐	ihe
统	vov
追	yp
亚	aue
简	qp
练	vav
基	dht
选	wqp
推	awi
改	beh
退	vpd
味	lhe
举	ita
忍	boy
历	sxk
恐	fqo
引	vn
试	ogf
习	xi
导	cac
存	sn
莫	sj
志	hy
区	gw
汉	ib
右	slv
严	auq
态	goy
买	vsg
社	hh
佛	evt
议	oow
树	fb
止	ni
块	hbt
守	oa
挥	ayh
胡	dwy
散	swe
仅	ebu
隐	cyx
怒	cby
床	ufv
苏	sxt
料	psd
股	wqh
局	bv
班	gug
图	nes
岁	jrk
礼	hx
独	rk
初	pbd
福	hfl
顺	qd
狂	rg
默	ns
巨	gb
既	xvg
松	ft
证	ofn
烈	frm
否	dl
恶	auy
治	iv
排	ali
费	vtk
拍	aeb
医	gq
寒	ost
哭	lls
温	ijm
府	ue
担	ajf
称	ry
余	tff
钟	tl
泪	imf
烟	un
仍	ev
具	mt
忘	uy
恩	ngy
毕	rrd
蓝	snq
陆	cax
究	py
抓	aek
压	sh
呆	lf
河	ia
迷	pp
枪	ftv
组	vm
权	fbu
叹	lbu
孙	vma
卷	ugv
查	fjf
毫	orm
圣	bh
草	sjd
较	ho
胜	wwg
遇	kp
史	lw
堂	nh
防	co
据	abd
猛	rvm
骑	xg
土	ht
卡	kmo
助	mxk
京	oma
银	tvn
永	okv
质	edk
屋	bhk
须	td
副	flj
换	ayk
刺	fkm
属	bq
闻	pa
境	hij
禁	ffh
阴	cw
共	sti
负	yk
弄	gs
翻	qpj
虎	mu
层	bsv
喊	ldf
逃	qs
晓	jaq
雅	hwi
参	vg
射	wa
婚	cta
君	xql
划	gm
坚	nbh
价	ett
柔	cq
扬	av
科	rs
按	ao
狠	rvn
野	kc
秦	gr
秘	ryq
熟	ovy
置	md
仙	ejs
模	fsj
伸	ek
波	ivp
肉	ktt
假	ebs
齐	pti
舞	qsf
脱	wul
广	uu
姑	cd
投	aqh
顶	ad
致	heh
责	hkb
景	jom
维	vwi
设	oqh
坏	hdu
啦	lai
秀	rvj
败	ke
眉	bmf
州	iqc
药	svw
承	vkf
案	ocf
狼	rov
专	sxo
偷	etf
画	fjx
吴	lfg
店	um
哦	lqa
弹	vu
抬	avl
标	fhs
秋	ruo
良	ovn
际	chs
状	usq
烦	ud
午	qdi
摆	amh
戏	bg
桌	mj
船	qql
短	qf
村	fac
某	ssf
摸	as
付	eac
演	iof
规	gkx
封	hha
握	abh
唐	ux
藏	sgx
震	dsn
虚	mk
纪	vbj
凌	sht
嘛	lp
梅	fqb
紫	nrb
歌	ala
临	nqj
毒	hbm
宗	ohs
著	shj
索	dyb
印	tfx
寻	xac
湖	idw
劲	bf
职	alt
恨	yv
婆	ivc
杰	fuo
羽	xxi
咱	ltk
素	hbs
凡	qod
值	edm
飘	dhq
养	ugt
嘿	lne
普	uk
宁	oan
吓	lak
夏	dme
读	odv
牛	wn
仿	eog
胸	www
富	ofl
宇	ofa
骨	mg
智	qlj
纷	vtb
升	qsj
叔	kmb
善	uul
架	xlf
卖	dvs
袋	ego
网	kww
朱	wti
骂	llx
略	je
杯	fdu
环	gd
罪	mli
窗	pr
柳	ftm
厅	sa
搞	aol
端	ijs
洞	ik
适	rp
拥	at
释	qpb
洋	iug
肩	iwy
闹	po
洗	iw
灯	uan
借	esj
伯	eeb
免	yl
菜	sef
验	xtf
凤	qbu
徐	rt
型	fsm
娜	cva
暴	jst
讨	oac
辈	lhc
懂	ysw
腿	wv
妙	cmq
效	otw
优	edo
套	gha
丁	an
趣	da
妖	ceo
束	flv
杂	yfv
诗	oha
迎	tx
舍	tre
旧	nj
委	rc
笔	qrm
狗	rw
鲜	qug
纸	vta
抗	aoq
探	ayt
韩	dja
尼	br
控	apf
珠	gwt
抽	ako
归	uxl
挺	aex
奋	gjt
陪	ci
避	bl
园	nfh
托	aqa
训	oqc
勇	btx
聊	atm
奶	cvj
庄	uht
奔	gds
镇	tdm
研	dfs
配	gbj
介	tti
尊	uga
冒	ksm
虑	my
丹	wo
舒	tr
蛋	vnk
哼	lo
宋	ofv
济	ip
妇	cxl
箭	quw
择	aba
犯	rvi
欣	eei
甲	kj
欧	gwe
课	oj
扑	amo
菲	sli
燕	sfl
曲	ks
躲	wqf
玄	ovo
幻	vvi
茶	stf
折	aej
伊	exq
傻	erw
姓	cwg
源	ise
洛	iel
遍	in
臣	sc
犹	rdo
占	mlv
漂	idh
挑	aqs
获	srs
绿	vx
峰	jed
疯	pq
森	fff
妻	dxc
恋	pyi
误	olf
拜	tfd
伟	eav
移	rrr
纳	vkt
党	nqr
罢	mhv
腰	wd
巧	fsk
孤	vq
闭	paq
圆	nl
碰	du
镜	tij
软	hei
厚	sjv
累	jbs
昨	jq
幽	jv
悲	lyi
丈	so
牌	twd
降	cea
颜	iqt
偏	ein
省	mqm
糊	pd
馆	rob
烧	uaq
财	ka
舰	qk
汗	ihg
奈	ghs
操	all
迹	ppd
悄	ymw
尖	mgd
鲁	qjr
锋	te
圈	nu
油	iko
撞	aik
瞬	me
忆	yvi
盖	umn
尤	do
徒	rdk
乡	vqp
概	fxv
荡	siv
艺	svi
增	huj
祖	hm
困	nf
殿	bst
迅	vdp
企	tni
惨	yvg
限	cvn
凭	eeq
剧	bdm
碎	dot
躺	wns
缘	vbd
凉	som
腾	wug
织	vlt
抢	atv
替	gg
孔	vxi
康	uxk
惑	glf
唯	lwi
率	ovs
惯	ybd
登	bfl
互	fbm
盯	ma
稍	rmw
宣	ofj
唱	ljj
剩	rur
咬	lot
育	ovw
诸	ohj
触	ytk
晨	jsn
策	qfk
材	faq
补	pmo
私	rvv
纯	vax
艾	swl
贝	kb
庭	uex
挡	amx
晃	jm
吉	hl
吹	lei
仔	evk
仇	eyf
农	yr
征	rfn
帅	umv
附	ce
缺	wb
豪	ods
亦	pi
杜	fht
努	cb
判	uam
谋	oss
胆	wjf
尘	mht
扎	axi
滚	iot
迟	bop
翼	xxj
闲	pfv
灰	su
朵	qfv
盛	dvm
梁	ibt
晶	jj
餐	mrb
伦	etr
娇	cet
侧	ekm
愣	ymo
轮	htr
昏	ta
抖	asd
陷	cyr
敏	qbe
词	ovf
颤	on
阶	ctt
苍	stv
距	ngb
川	qc
扫	axl
忧	ydo
童	ikk
丢	evv
臂	blo
逐	dpd
傲	ehw
戴	dgj
芒	suw
伴	eua
袭	dqo
供	est
积	rlt
测	ikm
遥	ewp
阻	cmi
例	efr
睁	myx
岛	yjs
瞪	mb
博	dfa
猜	rhw
益	utm
净	syx
泽	iba
炼	uav
监	nqm
鸡	by
珍	gt
伏	esq
绍	vbl
曹	sjj
爬	ecb
丫	uns
炸	uq
凶	wxg
郎	oxv
宿	oed
醉	got
革	ge
瞧	mw
奥	rpg
输	htf
忠	lny
颗	jfd
仁	esi
鸟	ya
骗	xin
浩	iwl
塔	hsy
绪	vhj
枫	fqw
拔	asb
赞	wqw
炮	uwc
凯	jbq
邪	hcj
芳	sog
浑	iyh
夺	gac
宽	osk
旋	oqv
扭	abc
洁	ihl
悉	qpy
擦	aow
慧	dd
典	kst
赏	nk
评	ohu
纵	vtt
莲	shp
雾	dex
跃	neo
壮	uhf
贴	kml
隔	cf
健	exa
辛	ox
抵	ata
彻	rab
摩	ptu
编	vi
肚	wht
插	awr
磨	pdh
御	rqf
耐	sac
惧	ymt
氏	tai
辉	mhy
扶	agu
恢	ysu
貌	yeq
述	fop
票	dhs
录	xkv
拖	aqc
膀	wou
鹰	uew
孟	vmn
递	uvn
瑞	gjs
货	erk
琴	ggt
踪	no
码	dxm
玲	gto
晕	jyh
损	alk
轩	hhg
粗	pmi
掩	agk
屁	brr
仰	etx
零	dt
盟	jwm
贼	kgs
悟	yfc
固	nd
讶	ohy
滑	img
郁	swc
辆	hfk
猪	rhj
妮	cbr
挣	ayx
旦	jfi
估	edg
甘	ssi
佩	eqf
莱	sfp
享	ovk
吼	lvx
构	fwv
粉	ptb
吻	lwt
瓶	usa
偶	eky
戒	gsj
浓	iyr
毁	rfq
销	tmw
迪	kpd
拒	agb
绕	vaq
勒	gx
嘻	ldl
尾	brm
帐	mth
废	uxb
延	qn
敲	omb
烂	uus
曼	jmb
厌	ssq
宜	omi
羞	ub
喂	ljg
吟	lto
洲	ii
爹	twr
艳	dyc
晴	jh
抚	af
协	dxt
央	kgd
悔	yqb
肖	mwy
缠	vuk
脆	wys
痕	pvn
伍	efc
寂	okm
启	ilv
薄	sif
侯	ebq
劝	bx
郭	ovc
奴	cbu
鸣	lya
彼	rvp
扔	avj
撒	asw
豫	cyl
检	ftf
针	tdi
耀	mhx
痴	pql
姆	cbm
篇	qi
椅	fga
熊	vwr
狐	rqu
蒋	sur
踏	nkj
隆	cef
括	are
唉	lvq
穷	pxk
聪	aul
唤	lyk
泰	gkv
版	teb
旗	oqd
仪	eow
焦	wuo
猫	rsj
挤	apt
拾	aye
荒	suq
姿	sec
域	hgl
脉	wok
授	aey
狱	ros
欺	dei
访	oog
桥	fet
锁	tmk
霸	dgw
牵	gy
池	ic
钻	tml
港	ist
廷	exn
玛	gxm
奉	gao
扯	ani
夹	gue
辞	rox
岸	jsh
岂	jbj
屈	bxx
恼	ypx
哲	ael
季	rvk
召	blv
丧	dug
尝	nsv
载	dgh
瘦	prn
颇	vdk
茫	siu
染	iyf
肃	xtt
惹	ssl
乔	eti
趁	dtt
铺	tfu
脏	wuh
吕	llv
奖	urg
倍	eil
振	asn
婷	coa
牢	own
扰	ado
溜	itj
庞	udq
臭	tsq
悦	yul
赢	ukb
跪	ny
侠	egu
泉	ekv
劫	hvx
炎	uuo
泥	ibr
赌	kh
魏	rcw
罩	mm
疾	pqi
饰	rqm
符	qea
映	jkg
漠	isj
脖	wdy
饮	rei
沿	iql
懒	yfl
肤	wgu
桑	bbb
堪	hdx
燃	uws
卓	mjd
祝	hlq
赖	fly
宾	oef
贾	dkb
喘	ljs
焰	uyr
吵	lm
鞋	gh
库	uhc
裤	pu
踢	njw
姨	cg
酸	gv
阁	pel
箱	qfm
冯	sxm
邦	dcj
钢	tkw
促	env
碧	ged
援	aeh
忌	byi
抹	aho
锐	tul
袖	pk
络	vel
嫁	cod
咒	llq
撤	aov
键	txa
湿	ijk
恰	yy
审	oke
贤	nbk
刹	wfm
袁	hlr
序	uc
湾	ipv
崇	joh
墨	nht
梯	fuv
桃	fqs
驾	xlx
浅	ifg
径	rb
饿	rqa
疲	pvp
搬	aqq
润	ipg
蛮	pkc
蒂	sou
涛	ida
予	cu
勾	wvv
惠	gyi
析	fej
撑	ant
措	asj
币	qmv
薇	srf
酷	gwl
祥	hug
怖	ysm
侵	exy
岩	jdh
扮	atb
盈	vbm
斩	hej
尺	bod
签	qt
稀	rws
汽	iqq
姬	csc
愧	ywu
汇	igf
粮	pov
仗	eso
笨	qff
奏	gfg
歉	uxn
甩	wxi
怔	yfn
允	vqr
竞	ilq
祸	hlk
耶	acj
绩	vhk
诱	orv
呜	lew
黎	rwq
租	rmi
砸	dgm
麽	pqv
窝	plk
弥	vym
返	ebp
匹	hxi
啥	ltr
凑	sgf
奸	chg
陌	cdj
叛	uae
核	foi
卧	smo
幅	mfl
眨	mqp
耗	dtr
洒	idx
怡	yvl
详	oug
扣	alv
哇	lhh
丑	bc
勉	ylq
孝	hvk
矛	cqp
氛	qtb
衡	rqt
购	kwv
汪	ign
妃	cbj
罚	mo
棋	fdj
缝	ved
咐	lea
躯	wgw
愁	ruy
搜	arn
慈	uvv
肥	wcb
笼	qdq
篮	qnq
俱	emt
惟	ywi
柜	fgb
捉	anv
悬	mvy
霍	dwi
泄	ihi
咽	lng
秒	rmq
勤	gsx
屏	bus
霜	dfm
袍	pwc
蝶	khf
祭	whs
胁	wxt
璃	gpx
赚	ku
锦	tem
熙	scu
寺	ha
昌	jjr
贺	xlk
捕	afu
陵	cht
咳	loi
扇	ix
虹	kfo
撕	ade
蔡	swh
彭	dto
宠	odq
贪	tov
誓	aeu
盒	ymn
披	avp
饶	raq
跌	nqg
肌	wqj
抑	atx
纹	vpw
宏	osv
幼	vxk
萍	sih
驻	xog
亿	evi
播	aqp
俄	eqa
挨	avq
仲	eln
迈	fwp
辩	ooo
埃	hvq
艘	qrn
琪	gdj
僧	euj
渡	ius
卑	wdi
鼠	rbu
讯	ovd
艰	bvn
斥	eod
裙	pxq
翠	xxo
饱	rwc
掠	aom
询	owj
勃	dyv
矮	qrc
瑶	gew
赐	kjw
闯	pxm
姚	cqs
瑟	ggy
渴	ijw
昂	jtx
沟	iwv
咕	ldg
驶	xlw
摄	aab
贫	tbk
辕	hhl
婉	cor
碍	djf
冠	yfh
魅	whe
玫	geh
裁	dgo
坡	hvp
鸿	ify
邓	bcj
歪	dfn
乏	qpe
巫	ftt
衫	pto
阔	pir
泣	iid
韦	avi
恍	ymh
贯	bdk
魄	ewu
柄	ffk
患	lln
覆	dr
蜜	oyq
婴	kkc
励	sfw
锅	tlk
陛	cr
帕	meb
咖	lxl
嫌	cux
胳	we
挖	apv
啪	lae
凄	sdx
眠	mc
穆	rem
啡	lli
吾	fcl
坛	hsv
脾	wwd
恒	yfj
屠	bhj
玻	gvp
蓉	sp
耸	tta
膊	wfa
後	rve
逆	uxp
寿	dac
驱	xgw
猴	reb
佣	etn
毅	idq
舅	rjx
铜	tkf
娟	clw
眯	mp
吩	ltb
匪	gli
牧	weh
役	rqh
寄	oga
诡	oys
纤	vwk
腐	uea
姻	cng
渊	itp
晰	jfe
骚	xbo
柯	fal
筋	qwx
崔	jwi
灿	ujs
捷	afx
淋	iff
弗	vti
辑	hla
廊	uox
畏	jg
歇	jwt
裹	ojf
苗	sjt
盼	mtb
咯	lel
耍	scn
煞	yxe
寝	oux
瞒	ms
嫂	crn
纠	vxg
慨	yxv
嚷	los
驰	xc
拐	alx
宴	ojc
岚	jqw
浴	itt
誉	itu
乳	evx
仓	tvi
逝	aep
喉	leb
逛	rgp
樱	fkk
哗	ler
涯	ish
捧	aga
铭	trl
障	cij
摊	abw
跨	ngf
妥	ecn
揉	acq
晋	auj
寞	osj
污	ifs
嘲	ldj
吊	lmv
乾	djq
伪	eox
嗓	lbb
呈	lg
卿	txv
籍	qdt
裸	pjf
链	thp
灌	isl
畅	kvt
逍	mwp
帽	mks
阅	pul
踩	nef
窜	pll
哑	lau
趴	nti
植	fdm
媒	css
昭	jbl
尹	xqp
档	fmx
趟	dns
沾	iml
朴	fmo
瞎	mod
鞭	gef
俺	egk
翅	dbx
肠	wvt
雀	mwi
慎	ydm
盆	tbm
迁	wpd
镖	tdh
丘	efi
蠢	gjk
庙	uko
潘	iqp
拓	adh
纱	vmq
漏	ibd
谨	ogs
珊	gww
仆	emo
宙	oko
尉	bha
屑	bmw
叮	lan
捂	afc
涩	ibo
诧	ooq
柴	nrf
杆	fhg
涵	ivk
坠	cth
赔	ki
嘟	lhj
崩	jww
薛	syo
税	rul
枯	fdg
译	oba
帘	pmv
愉	ytf
骄	xet
羡	use
糕	puu
愚	ky
疏	vno
堵	hhj
腕	wor
芸	ssv
溪	iev
殷	exv
鼎	mxt
稿	rol
哟	lvw
冤	yyl
症	pfn
咧	lfr
湘	ifm
嫩	cfl
肆	hxa
宰	oox
腔	wpf
哩	lkk
豹	ywo
鉴	nqw
绑	vdc
潇	isx
桂	fhh
兮	tsk
雯	dpw
颠	dmt
狮	ruf
契	dbg
骇	xoi
揭	ajw
妄	ucn
坑	hoq
伐	egg
矩	qgb
葬	sfr
诀	obt
鄙	ldn
柏	feb
躁	nll
霉	dqb
侦	emk
冻	sam
娅	cau
庸	uxw
筹	qda
削	mwm
砰	dhu
耿	auo
牺	wdx
筒	qkf
遂	udp
旭	yjr
惶	yeg
痒	pug
竖	nbi
龟	ykd
斑	gpg
儒	eds
嫣	cfn
宅	oqa
押	akj
胃	jwy
旨	rjr
册	wwf
膝	wft
浸	ixy
栏	fus
衷	onr
艇	qex
岗	jkw
赴	dmo
斧	twe
颊	gud
疆	vhf
炉	uie
塌	hjx
乞	qvi
旺	jgn
烤	uhs
逊	vmp
贱	kfg
辨	ouo
愕	yll
晌	jrn
麟	ipr
腥	wjw
粒	pid
拟	axo
俏	emw
杖	fso
芝	spe
夷	gvg
衬	pac
佐	esf
巷	stc
捡	atf
桶	fbt
泼	ixb
滩	ibw
琼	gom
昊	jfg
帆	mqo
搏	afa
颈	bfd
噢	lrp
贞	mkb
凰	qeg
哨	lmw
拆	aeo
茹	scl
劣	mqx
嘱	lbq
沃	ieo
厢	sfm
摘	aou
咋	lqm
坤	hke
俯	eue
媳	cty
嘶	lde
贡	fkb
碌	dxk
拢	adq
谭	odj
翁	tvx
辜	dox
廉	uux
械	fgs
贸	tkb
辅	hfu
呐	lkt
斌	pfg
填	hdm
窃	pab
抄	amq
溢	iut
妒	cie
吁	lfa
掀	aee
芙	sgu
撇	aum
胞	wwc
轿	het
妨	cog
拂	avt
衰	ofr
循	red
挪	ava
蓬	sed
垃	hid
账	kth
驳	xw
署	mhj
顽	fhd
圾	hvo
枕	fy
咦	lgv
厕	skm
攀	fww
妍	cfs
拽	akq
荆	sfs
妓	cdb
壶	hyk
於	ots
寇	ofh
鹤	ywy
钥	twy
骤	xab
渺	imm
刊	hmd
肢	wdb
烛	ukc
孕	vvk
绽	vof
棉	fem
俘	eev
盔	sum
诞	oqn
兜	etb
凛	son
嚣	lld
溅	ikf
笛	qko
舱	qtv
鸭	kya
噬	lqf
钉	tan
躬	wvg
缕	vpc
咚	les
撼	adf
蕊	syy
侄	ehk
佑	esl
雁	sew
践	nfg
沐	ifv
菊	swp
蜂	ked
兆	qss
搅	aiy
尿	bkv
黯	nij
歹	frk
蓄	sov
朦	wsy
怯	yhv
叨	lbd
纽	vbc
聘	aks
腻	wgs
剥	xkm
彪	mto
氓	uca
榜	fou
逻	mrp
壳	hyq
储	eoh
啤	lwd
匠	gej
悍	yjh
昧	jhe
泊	ieb
篷	qed
狡	rot
轨	hyf
汹	iwx
携	awv
磊	ddd
隙	cmj
仑	tri
瞄	msj
胧	wdq
趋	dyx
挠	aaq
煌	ueg
擅	aon
卒	ott
惫	ejy
瞅	mru
犬	sq
砖	dsx
矣	vqi
昔	sjr
裳	nor
骆	xel
雇	iwi
阎	pyr
骷	mdg
鸦	hya
妞	cbc
墅	kch
焚	ffu
绘	vts
梳	fov
肿	wln
魁	wsd
耽	ayq
擒	atp
陡	cdk
璋	gij
茂	sdw
蹄	nou
瞥	umt
瞳	mik
髅	mpc
绣	vr
硕	ddk
炒	umq
邮	kcj
嫉	cp
届	bko
嗡	ltv
娱	clf
喧	lof
脂	wr
膛	wnh
沧	itv
疚	pyo
扁	inc
搁	ape
茅	scq
坟	hpw
掐	ayr
瑜	gtf
茵	sng
苹	shu
旷	ju
蓦	sjg
诈	oqm
沫	iho
菁	shw
粹	pot
琢	gdo
腊	wsj
钦	tei
喻	ltf
宪	owq
锻	tef
饥	rqj
侃	elq
粘	pml
媛	ceh
谊	oom
恳	vyi
厮	sde
锤	tws
聂	abb
贩	keb
翩	inx
呻	lke
枉	fgn
拘	awl
煮	hju
址	hn
匕	ri
渗	ivg
览	nqk
敦	ove
冉	kht
呃	lsv
峻	jvt
栽	dgf
嚎	lod
汁	idi
傍	eou
禀	onl
珑	gdq
邵	blc
萌	sjw
窄	pqm
阮	cfh
蹈	ner
碑	dwd
婶	cok
煤	uss
寓	oky
栈	ffg
滞	isy
倘	ens
杭	foq
狈	rkb
峡	jgu
侣	ell
芦	sie
蔓	sjm
蒸	svk
禄	hxk
胀	wth
淌	ins
伞	tud
姊	cqx
钩	twv
妾	icn
蜀	mwk
蝴	kdw
萝	smr
弩	cbv
祷	hda
稚	rwi
圳	hq
徽	rfb
衙	rfc
咸	dfl
陋	cfk
奢	ghj
罐	wsl
霄	dmw
毙	rrf
敞	neh
嘘	lmk
灼	uwo
姗	cww
倪	erq
挫	att
咪	lpm
捣	ayj
燥	ull
泳	iok
澈	iov
焕	uyk
酬	giq
筷	qyb
宵	omw
揪	aru
缚	vfa
蚁	kow
喇	lfl
拎	ato
棠	nfv
咙	ldq
哧	lht
棺	fob
璇	goq
肝	whg
剂	ptm
疤	pcb
渔	iqy
沮	imi
廖	uxx
皓	ewl
勋	lkx
恕	cly
虐	mxl
虞	mlf
综	voh
瘾	pcy
驴	xie
晒	jdx
卦	hhm
迦	xlp
窥	pgk
堕	csw
葡	swf
帖	mml
屡	bp
蛛	kwt
盲	umf
碟	dhf
囚	nte
揽	anq
裴	lor
捞	asy
吏	flw
铮	tyx
萄	sww
盏	fgm
喔	lbh
勿	wto
蔑	smd
淹	igk
麒	idj
喽	lpc
栗	dfv
绷	vww
惚	ywt
桓	ffj
桩	fuh
坊	hog
履	brq
璐	gne
菩	sil
巢	vjf
畜	ovj
锡	tjw
仕	ehf
芹	sej
僻	ebl
絮	clb
浆	urk
瘫	pbw
啧	lhk
磁	duv
冈	kwl
逮	xkp
搓	auf
胶	wot
脊	sst
噩	gll
绰	vmj
呕	lgw
嚼	lem
谐	orr
揣	ajs
殖	frd
拧	aoa
伺	evf
霖	dff
驼	xor
衔	rta
掷	aug
卸	qfn
炽	ult
惭	yhe
框	fgg
捆	anf
眩	mov
谜	op
塘	hux
阱	cst
亨	ovl
奕	pgd
蚂	kxm
猩	rjw
滨	ioe
沁	iyi
跋	nsb
藩	siq
舔	rfg
捐	alw
歧	ndb
隋	csf
蹭	nuj
甄	dha
嗤	lxf
缸	wfo
嬉	cdl
哮	lhv
熄	uty
窍	pfs
俞	tfw
掘	abx
屎	bpm
乍	qmo
弧	vqu
槐	fwu
铠	tjb
襟	pff
梨	rmf
嗅	lts
纲	vkw
渠	igb
捅	abt
扛	afo
忖	yac
匈	wwx
扒	ati
雍	ovq
霓	drq
斋	psr
稽	rdr
沦	itr
揍	agf
瞟	mdh
漪	irg
暑	jhj
窟	pbx
钓	two
鳞	qpr
瓷	sea
萱	sof
株	fwt
倭	erc
鞘	gmw
绞	vot
睿	myf
噗	lku
唔	lfc
喀	loe
涕	iuv
拣	aav
谣	oew
叽	lqj
葱	swt
婢	cwd
铸	tda
绮	vga
胤	qvw
秩	rqg
畔	jua
粥	vpv
奎	ghh
绸	vwh
茨	sse
熏	wne
蹬	nbf
诏	obl
岔	tbj
叭	lti
咆	lwc
滥	inq
梧	ffc
澳	irp
浙	iae
甸	wjt
绯	vli
诛	owt
鲍	qwc
刁	vfi
厥	sux
蚊	kpw
鞠	gwp
茗	srl
眷	ugm
戮	xxt
唬	lmu
骏	xvt
踹	njs
漓	ipx
蝇	kl
凸	nfn
酿	gov
蚩	xfk
唾	lws
琐	gmk
澄	ibf
猾	rmg
煎	uwm
窒	phk
虾	kak
蝠	kfl
钞	tmq
唧	lxv
觑	mkk
哽	lfj
娥	cqa
讪	ojs
耕	dts
暧	jey
浇	iaq
嗨	liq
疫	pqh
兢	dqd
箫	qx
颅	mbd
啼	lou
绅	vke
杉	fto
嗜	lhr
券	ugb
炯	ukl
霎	dic
迭	qgp
彷	rog
觅	ekx
娴	cpf
抿	aca
稻	rer
泻	iys
怠	vly
龚	dqs
绒	vgs
讳	oav
勺	wod
函	vkx
颂	tvd
巍	jrc
脯	wfu
镶	tos
漾	iuo
缴	veo
藉	sdt
逞	lgp
膏	owy
戳	xxw
凹	kfi
叩	lxj
禽	tpx
懊	yrp
懈	yyt
蛟	kot
芊	swk
慑	yab
跺	nqf
跄	ntv
蚀	rkc
栖	fdx
蔚	sbh
铲	tiq
坪	hhu
筝	qyx
腮	wjy
狰	ryx
踱	nus
苑	srv
秉	rxl
猿	rhl
佟	ees
悯	ypp
唠	lsy
肘	wac
拇	abm
霹	dbl
婕	cfx
禹	qlk
啃	lnw
匀	wsi
怅	yth
聋	dqa
拯	avk
忿	tby
韧	avb
邹	yxc
梢	fmw
肋	wxk
浦	ifu
炭	jsu
曦	jur
簇	qoq
螺	kjb
屯	axg
悴	yot
匡	ggn
冀	urj
倔	ebx
橙	fbf
陕	cgu
筱	qen
叱	lri
矜	cqt
詹	yst
芷	sni
惺	yjw
浊	ikc
睫	mfx
睬	mef
鸽	yya
吨	lax
笙	qwg
戟	djg
沼	ibl
谍	ohf
昕	jej
蛊	kmn
煜	uji
祀	hck
罡	mfn
荫	scw
酥	grh
懦	yds
峨	jqa
轴	hko
伽	exl
捶	aws
棘	fkf
嗣	lnv
钗	tbo
袜	pho
妩	cfd
偎	ejg
窦	pdv
溶	ipt
膨	wdt
峙	jha
缉	vla
徊	rnl
呗	lkb
衅	qmu
砂	dmq
昼	boj
迸	usp
斟	dxs
舆	rhf
靓	hwk
旬	wjr
窑	pwo
萎	src
涟	ihp
瘩	psy
梵	ffq
靴	ger
侥	eaq
兑	ulq
徘	rli
芽	shy
闵	ppw
嗷	lhw
芯	syi
澎	idt
邢	fsc
绊	vua
蜘	kq
憎	yuj
靡	pli
褚	phj
嚓	low
珂	gal
崽	jjy
婵	cuj
悸	yrv
晦	jqb
涅	ijh
恬	yre
渣	ifj
屉	bhi
缭	vgu
绢	vlw
袱	pes
黝	nvx
茄	sxl
寅	ofk
悻	yhu
祟	xxh
蛙	khh
苇	sav
嵩	jol
茉	sho
咏	lok
凿	kud
粪	pst
噪	lll
菌	snr
蝙	kin
晟	jdv
禧	hdl
攒	awq
旱	jhg
虔	mpw
琛	gyt
榴	ftj
忑	ayi
匣	gkj
忐	kyi
钝	tax
廓	uov
惘	yku
漉	iil
蟹	ytb
曳	kqp
赎	kdv
壤	hos
忡	yln
冶	svl
姝	cwt
竿	qhg
嘈	lsj
蚕	fgk
剖	ilm
颁	tbd
缀	vbb
汀	ian
谕	otf
斐	lpw
皙	fee
缪	vxx
蔷	sdu
恤	yqm
咄	lxx
馒	rjm
矫	qet
痞	pdl
橘	fcq
瑾	ggs
烙	uel
攘	aos
汰	igo
溺	ivs
铅	tql
咔	lkm
芭	scb
戎	gso
褐	pjw
吆	lvo
鹃	lwy
帜	mlt
鄂	llf
蔼	soj
穗	rgy
亩	ojt
绎	vba
牟	vwn
咨	sel
奄	gkd
梓	fox
绚	vwj
阀	peg
烘	ust
惋	yor
驯	xqc
墟	hmk
鬟	hmf
茬	ssn
骸	moi
峭	jmw
缅	vgi
洽	iye
暄	jof
裔	ork
砚	dkx
锥	twi
辙	hov
惦	yum
铛	tmx
枣	fks
桦	fer
邃	pud
橱	fsf
搔	abo
腑	wue
萤	syk
枢	fgw
憬	yjo
庵	ugk
叼	lvf
嫖	cdh
苛	sal
锣	tmr
蹑	nab
拌	aua
殴	gwq
喋	lhf
糙	pwl
貂	ybl
葵	sbf
颐	sdk
皂	eai
眈	myq
扼	asv
眺	mqs
孜	veh
玺	ymg
偌	ess
蹿	np
弛	vc
螂	kox
趾	nn
妲	cjf
掺	avg
驿	xba
惬	yg
抡	atr
憧	yi
宦	osc
筐	qgg
瞻	mys
湃	itf
俨	eau
跷	naq
撅	asu
煽	uix
呱	lqu
缰	vfj
衮	otv
殆	frv
谴	olk
蔬	svn
飒	iqw
婧	chw
阐	puj
荧	syu
霏	dli
瘟	pjm
芜	sfd
崎	jga
俐	erm
屿	jsf
垄	dqh
畴	jda
杠	ffo
鬓	hoe
晏	joc
鞍	goc
钮	tbc
珏	ggo
钰	tgo
噔	lbf
驭	xbu
靶	gc
萦	syb
韬	ave
恙	uyi
竺	qsi
吝	plv
荀	swj
癫	pdm
嘭	ldt
菇	scd
瘪	ptt
踌	nda
榕	fpt
昵	jbr
躇	nsh
啰	lmr
酌	gwo
丙	fkt
涎	iqn
砌	dab
鸾	pya
烨	uer
噎	lhy
驹	xwl
噼	lbl
咎	eml
亵	oay
陨	clk
蠕	kds
冕	ksy
雌	nrw
茸	sar
掰	ttb
蹙	dkm
橡	fyl
佯	eug
笃	qxm
崛	jbx
稼	rod
桀	raf
拚	avs
汐	irk
锈	trv
磅	dou
壕	hod
娄	pcn
撮	aja
玑	gqj
祠	hvf
黏	rtk
珀	geb
睽	mbf
栓	ftg
邑	lcb
瑕	gbs
磋	duf
粟	dpm
薯	smh
沪	iie
讷	okt
岑	jto
玮	gav
迂	fap
伎	edb
鲸	qom
洼	ihh
蹊	nev
寐	oxh
肾	nbw
鸯	kgy
這	up
涧	ipj
崆	jp
甭	dtn
笠	qid
扈	ilc
哝	lyr
芮	skt
卉	dsj
诬	oft
札	fxi
婊	chr
扉	ili
疮	ptv
巅	jdm
坞	hew
剌	flm
鳄	qll
捺	agh
悼	ymj
茧	skc
毋	bso
曙	jmh
馅	ryr
簸	qdv
妳	cym
叟	rnb
拴	atg
嬷	cpq
稣	qrh
痹	pja
垣	hfj
蛤	kye
蛾	kqa
瑚	gdw
個	end
熔	upt
雏	yxw
惆	ywh
拗	avx
燎	ugu
薰	swn
蕃	sqp
捋	aea
籁	qfl
髦	hrm
飓	qwm
簿	qif
迢	blp
汩	ije
闸	pkj
狩	roa
蜥	kfe
侨	eet
劭	blx
烹	ovu
咣	lmh
寰	omf
紊	pbs
稠	rwh
蟆	ksj
炊	uei
忻	yej
炳	ufk
腆	wks
酋	ugo
赃	kuh
拈	aml
抒	acu
袄	peo
褂	phh
孺	vds
胭	wng
赘	hwe
礁	dwu
嫡	cou
珉	gca
钳	tss
窿	pce
骋	xks
嫦	cnm
槛	fnq
曜	jxx
遐	bsb
蹋	njx
飕	qwr
麾	prm
渍	ihk
猥	rjg
篝	qsk
枷	fxl
蜒	kqn
皎	eot
霁	dpt
咫	bol
檬	fsy
奚	evg
溯	iux
纺	vog
篱	qpx
刨	wcm
忏	ywk
盎	kgm
戾	isq
咀	lmi
屹	jqv
庚	uxt
隘	cut
绛	vea
焘	dau
璨	gmr
跤	not
锵	tur
痊	ptg
嫔	coe
臻	hgr
泯	ica
糜	ppm
缥	vdh
褥	psa
魇	ssw
汶	ipw
馋	ryl
渎	idv
蜿	kor
抠	agw
棣	fxk
沓	kjr
喏	lss
琶	ggc
缈	vmm
缔	vou
酝	gsv
耷	gar
弼	vdj
柬	fnu
拷	ahs
柿	fom
琵	ggr
沂	iej
蕙	sgy
帛	emv
柠	foa
饵	rar
撂	aje
乓	efo
轲	hal
髯	hkh
娉	ck
圭	hht
肪	wog
瞩	mbq
啄	ldo
蟑	kij
炖	uax
捎	amw
嗬	lse
蘑	spd
鹊	sjy
矶	dqj
羌	uxi
骼	mel
筛	quf
祺	hdj
馈	rlk
伫	eof
羿	xxs
铎	tba
啬	dun
舷	qov
矗	dmd
癖	pbl
匾	gin
瀛	iuc
珞	gel
毓	qbo
衲	pkt
恺	yjb
惰	ysf
诣	orj
谛	oou
啷	lox
佘	ths
黠	nhl
饲	rvf
虬	kxi
涤	ief
骡	xj
邯	ssc
笋	qxq
芥	stt
醺	gwn
舜	eyr
簪	qgq
蹂	nc
恻	ykm
甥	wjx
腼	wgi
驮	xgd
缤	voe
獠	rgu
锭	tof
阙	pux
粤	rps
琏	ghp
椎	fwi
唆	lvt
煦	jwl
嵋	jbm
毡	rml
碳	djs
鸨	rdy
躏	nsp
蜓	kex
咻	lef
捍	ajh
睨	mrq
娆	caq
玟	gpw
徨	reg
嗲	ltw
粼	pra
谑	omx
嚏	ldy
甬	btn
榨	fpq
倜	ewh
稷	rjt
妤	ccu
篡	qmg
晤	jfc
肇	iex
咂	lgm
帚	xy
瘤	ptj
瞠	mnh
嚅	lds
怆	ytv
镔	toe
撵	agg
裆	pmx
腺	wek
骁	xaq
箐	qhw
螃	kou
锢	tnd
晁	jqs
濒	inm
蝗	keg
烽	ued
辘	hil
莘	sox
瓮	tva
钊	tmd
篓	qpc
泓	ivv
宸	osn
鞑	ggp
胄	kwy
绥	vec
笺	qfg
荤	syh
迄	qvp
踞	nbd
慵	yux
幌	mjm
荻	sru
痪	pyk
骰	mqh
曝	jjs
涮	ibm
踵	nwk
涣	iyk
俟	evq
皑	ejb
瞑	myj
擞	apc
赂	kel
麓	ffi
铿	tnb
峦	pjs
涓	ilw
掬	awp
莓	sqb
怏	ykg
萃	sot
呲	lnr
蹒	nsf
睐	mfp
昱	jid
旌	oqw
摞	ajb
們	ekn
吠	lsq
濮	iek
卞	oak
琬	gor
谙	oij
啕	lww
轶	hqg
陇	cdq
纨	vyo
霭	doj
橄	fva
纶	vtr
垛	hqf
嗫	lab
盅	lnm
拄	aog
踝	njf
臧	gxs
岌	jvo
岱	egj
璞	gku
缄	vdf
秧	rkg
翱	egd
卤	mnw
靥	ssg
逅	efl
磐	qqd
斓	ppf
翊	ixx
叁	vgf
阖	phv
怂	tty
汲	ivo
垠	hvn
迥	klp
咛	loa
杞	fbj
痘	pfl
媲	crw
辄	hax
恪	yel
砾	dtm
蜕	kul
仨	efa
纣	vac
馁	rec
蜈	klf
镐	tol
窈	pvx
說	utl
秤	rhu
桢	fmk
悖	ydy
涔	ijt
偕	err
汴	ioa
桅	fys
隅	cky
琥	gmu
阚	pva
杵	fqd
婀	cca
昙	jsv
俑	ebt
侏	ewt
潦	igu
挲	imq
覃	djd
硫	dov
驸	xea
梆	fdc
笈	qvo
忱	yyq
恿	bty
胥	vnw
垦	vht
窕	pqs
滇	idm
邬	ecj
圃	nfu
咿	lex
舫	qog
藐	sye
逵	hth
戍	dod
榭	fwa
牠	wcy
熹	dlu
蟾	kys
霾	dyk
蔫	sfn
跛	nvp
岐	jdb
脐	wpt
糗	pts
螳	kn
哺	lfu
鹭	nel
蚣	ktv
炀	uvt
嵬	jwu
恸	ysv
隽	wvj
玥	gwy
籽	pvk
釜	twh
磷	dpr
沒	iwb
谄	oyr
恣	sey
溟	iyj
丕	dfi
峒	jkf
芋	sfa
觊	jbk
旖	oqg
筵	qqn
娣	cuv
涸	ind
颌	ydk
劾	oxk
趔	dfr
殇	frq
噌	lu
沽	idg
愫	yhb
鸢	gya
玷	gml
溥	ifa
疵	pnr
杳	fjr
聿	xao
镀	tus
祎	hav
崴	jdf
岖	jgw
雒	elw
镑	tou
臆	wi
蜗	klk
瞰	mva
郸	ujd
缆	vnq
楮	fhj
诠	otg
麼	pvo
犊	wdv
蟀	kov
荦	syw
竣	ivt
骥	xur
贲	dsk
胴	wkf
潼	iik
弑	wfg
匐	wfl
姣	cot
蘸	sgw
渥	ibh
蛐	kks
阂	poi
糯	pds
嵇	rdj
谒	ojw
绾	vob
舀	erj
噙	ltp
槟	foe
嘣	ljw
诃	oal
脓	wyr
樟	fi
蛰	ayo
咤	loq
捱	ash
阜	ydi
峥	jyx
濡	ids
瑙	gvr
碉	dwh
荃	stg
嗵	lbt
彝	bpb
臾	rte
篆	qbd
椭	fcs
沏	iab
颦	nmd
蛆	kmi
淆	iws
辎	hvj
踮	num
鳅	qru
會	tfj
隗	cwu
渤	idy
锏	tpj
遛	tjp
倌	eob
氤	qng
嶙	jpr
馗	yut
揶	aac
胚	wdf
敕	fle
夙	qfr
珈	gxl
锹	tru
迩	ymp
啾	lru
靼	gjf
沅	ifh
馥	rjq
槌	fyp
為	oww
褛	ppc
贻	kvl
礴	dsi
豚	wds
蚱	kqm
腌	wgk
耙	dtc
诽	oli
褴	pnq
恁	eey
呷	lkj
蚌	kdn
铝	tll
憩	rty
俾	ewd
鬃	hoh
祢	hym
鱿	qdo
蘅	srq
唷	lov
傥	enq
袈	xlo
豺	yaq
町	jan
坯	hdf
戛	dmg
贮	kof
剽	dhm
孬	dcv
镣	tgu
夥	jfr
過	npd
匝	gmv
珩	gra
诘	ohl
攫	amm
黔	nto
臃	wov
罂	kkw
酗	gwx
阪	ceb
冗	yqj
桧	fts
闳	psv
皿	mn
囡	ncn
辍	hbb
闰	pgn
煲	elf
怵	yfo
囤	nax
蚓	kvn
碴	dfj
姒	cxo
灸	you
蚯	kef
嗥	leg
谗	oyl
箩	qmr
碱	ddf
旎	oqb
谆	oov
粽	poh
牒	thf
泸	imb
蔺	spw
刽	tsv
诋	ota
惇	yov
缜	vdm
睑	mtf
葭	sbs
妪	cgw
經	bfv
噫	lij
镂	tpc
癸	bfg
沣	idn
笆	qcb
绉	vyx
抨	ahu
叵	glv
箕	qdj
坨	hor
颉	hld
姹	coq
赳	dxg
琮	goh
焊	ujh
纭	vsv
埠	hyd
泱	ikg
淙	ioh
榛	fgr
銮	pwj
嗳	ley
佶	ehl
犒	wol
饪	ren
砺	dsf
遽	mdp
嗟	luf
钙	taf
谚	oi
馊	rrn
雉	qwi
虱	vqk
锴	trr
赈	ksn
骠	xd
跆	nvl
瘠	pss
饕	lsm
佚	eqg
淄	ivj
谀	ort
镳	tiu
廿	sfi
偻	epc
绺	vem
沱	ior
袤	ocq
對	kua
苯	sff
佻	eqs
繇	ewq
魈	wmw
屌	blm
獗	rsu
鞅	gkg
蹶	nsu
雹	dwc
旯	jyf
洱	iar
哂	ldx
蔗	sus
饨	rax
奘	xh
芍	swo
淞	ift
腴	wrt
現	gmx
汾	itb
顼	gdk
濂	iuu
麝	iwa
鹞	ewy
蚤	bok
坂	heb
忤	yqd
洙	iwt
祗	hta
迤	qcp
眦	mnr
暹	jwp
僮	eik
钺	tgx
嘞	lgx
蛹	kbt
玳	geg
睾	qmh
螭	kpx
盂	fam
赁	eek
瑁	gks
俅	efk
侗	ekf
骛	cqe
宕	odh
堰	hgj
厩	sxv
鄢	fns
帔	mvp
蓁	sgr
杈	fbo
挞	agp
開	kfs
钏	tqc
煊	uof
缮	vuu
夔	utn
燧	uud
嘁	ldk
孱	bvv
懑	isf
邕	vlc
柩	fgy
耆	hrj
鹄	wly
龛	ydq
餮	frt
幄	mbh
鹘	mya
爰	ehb
倨	ebd
汜	ick
诙	osu
锃	tlg
璟	gjo
纰	vrr
绡	vmw
瞭	mgu
鏖	iwj
氢	qbf
楔	fdb
藜	srw
妫	cox
栀	fef
岫	jko
谥	out
骧	xos
犄	wga
葳	sdf
辇	ggh
魑	wpx
椿	fgj
伢	ehy
谩	ojm
琊	ghc
骅	xer
颍	rkd
闩	pfi
濠	iod
仞	ebo
玖	gyo
痿	prc
芑	sbj
撸	aqj
檄	feo
啵	liv
昶	okj
柚	fko
祐	hsl
陲	cws
亟	vlb
樽	fug
舶	qeb
莆	sfu
蛀	kog
琨	gjr
點	nml
棂	fxu
抻	ake
搽	ast
怩	ybr
嚯	ldw
韭	lfi
膘	wdh
酩	grl
忸	ybc
刎	wtm
彿	rvt
扪	apn
漳	iij
瑄	gof
仃	ean
佞	esc
裨	pwd
巽	ccs
黜	nx
滂	iou
徉	rug
僖	edl
纫	vbo
溉	ixv
範	qgv
胛	wkj
卟	lmo
锌	tox
遑	egp
跻	npt
珣	gwj
妗	cto
蒿	sol
岷	jc
魃	wsb
苋	skx
潞	ine
阕	pbf
铤	tex
涿	ido
薜	sbl
鲛	qot
睥	mwd
滦	ipf
稔	rto
頭	flu
锲	tdb
徜	rns
冼	swq
獐	rij
讧	ofo
氨	qoc
缯	vuj
菀	sor
炅	juo
碜	dvg
戗	tvg
犍	wxa
酊	gan
臌	wdd
钠	tkt
铀	tko
羯	ujw
挝	aap
邙	ucj
襁	pvl
渚	ihj
胫	wbf
箸	qhj
逖	rup
荟	sts
汛	ivd
盥	rkm
睚	msh
祚	hqm
砣	dor
烩	uts
氣	qpm
夯	gxk
驷	xn
蜞	kdj
灏	ijo
發	bvq
哔	lrr
擢	axx
徇	rwj
荪	svm
蹴	nom
谯	owu
忾	yqq
祛	hhv
膻	won
黢	nvt
仄	ste
唳	lis
烊	uug
孀	cdf
斫	dej
腚	wof
牍	tdv
秣	rho
榷	fyw
镭	tdj
庾	urt
媾	csk
嫒	cey
谌	odx
啮	lnt
闱	pav
蝼	kpc
篙	qol
膑	woe
問	klv
隍	ceg
罄	hbq
蕨	ssu
囵	ntr
橹	fqj
喱	lsk
話	ure
肓	uwy
榈	fpl
绶	vey
罹	myw
槁	fol
裱	phr
牦	wrm
荑	sgv
滓	ioo
腓	wli
砝	dhv
嗎	ldm
秆	rhg
荏	see
斛	yts
給	bye
恫	ykf
纾	vcu
麋	ipm
诳	org
寮	ogu
驽	cbx
囫	nwt
炷	uog
缙	vau
徕	rfp
弭	var
圜	nmf
撺	apl
儆	esw
魉	wfk
妊	cen
兩	fmr
矍	mmw
犸	rxm
哓	laq
酶	gqb
當	njt
缢	vut
鲫	qxv
藓	squ
佰	edj
痔	pha
觥	ytm
讓	uos
伉	eoq
猷	ugs
怄	ygw
牯	wdg
茀	svt
烜	ufj
轱	hdg
泵	dkv
擀	adj
蝌	kr
绻	vug
呔	lgo
纥	vqv
釉	qpk
翳	gqq
從	rtt
砧	dml
辔	vhv
胰	wgv
蜍	ktf
浔	ixa
趿	nvo
鸪	dya
霰	dsw
邊	tpo
诨	oyh
僭	egq
動	wkx
弁	vsj
湎	igi
栉	fsx
蹉	nuf
蓼	sxx
梏	fwl
鸩	yqy
虺	hkc
嘬	lja
疡	pvt
荞	set
煨	ujg
蛔	knl
焖	upy
祉	hni
桎	fhk
诿	orc
娠	csn
瓯	gwa
偈	ejw
殚	fru
胱	wmh
刍	yxl
糅	pcq
亞	fja
岿	jux
唁	lua
笳	qxl
齑	ptl
崂	jsy
狎	rkj
踽	nql
鳍	qhr
揆	abf
钹	tsb
侩	ets
帧	mmk
姮	cfj
種	rwk
骈	xus
仟	ewk
柁	for
蛭	khk
珲	gyh
痍	pgv
俦	eda
猢	rdw
镫	tbf
鼹	rbj
悌	yuv
裡	pkk
咩	lug
亓	faj
铩	twf
噱	lmd
硌	del
臉	wrl
脍	wts
汞	fkv
炘	uej
姘	cus
泅	int
铡	tkm
绦	vef
桫	fim
恽	yyh
薏	sij
蚪	ksd
屙	bca
窸	pqp
蒺	spq
觞	ytq
葺	sla
煅	uef
茕	syv
悱	yli
靛	hwo
拋	adx
箔	qie
璠	gqp
別	lwm
菅	sob
嶷	jrq
臬	tfv
岬	jkj
舢	qjs
肱	wsv
焙	uil
啖	luu
蜢	kvm
級	bvo
铨	ttg
胺	woc
旻	jpw
雲	dsv
堇	gsi
艽	syf
湟	ieg
瑭	gux
踅	aen
芨	svo
逶	rcp
嶂	jij
幾	vvg
钾	tkj
跹	nwp
徭	rew
鹌	gky
笞	qvl
仵	eqd
缛	vsa
椽	fbd
暝	jyj
酮	gkf
玠	gtt
囿	nsw
帏	mav
畹	jor
缦	vjm
铣	twq
舂	grj
碘	dks
芫	sfh
铢	twt
塬	hse
氯	qxk
倬	emj
實	obd
颏	odk
缱	vlk
篾	qmd
鋆	hws
柘	fdh
猕	rvy
桉	foc
砒	drr
邶	urc
洌	ifr
颛	jsd
蜮	kgl
骢	xr
柒	iaf
呖	lsx
饴	rvl
圩	hfa
茯	ses
圄	nfc
琚	gbd
钿	tjt
貅	yef
蛎	ksf
嫱	cdu
辂	hel
綦	dbs
笤	qbl
鼬	rbk
苜	smf
茏	sdq
艄	qmw
辚	hpr
撷	ahl
伥	eth
骓	xwi
疟	pxl
筌	qtg
屐	brd
猁	rrm
傩	ebw
帶	sfy
貊	ydj
鼐	vmx
剛	kuj
嗞	luv
獭	rfl
洮	iqs
獾	rsl
邛	fcj
赅	koi
擤	atj
咴	lsu
稗	rwd
竽	qfa
郾	gjc
铧	ter
師	yfm
铆	ttm
滁	ict
陂	cvp
喁	lky
湫	iru
钨	tew
钲	tfn
噹	lnj
蕲	suj
舛	rao
荠	spt
玕	ghg
稞	rjf
媪	cjm
笏	qwt
悒	ylc
晷	jem
戰	llj
宥	osw
摈	aoe
葶	soa
愛	eyy
阡	cwk
猗	rga
粕	peb
蚨	kgu
畲	thj
睇	muv
洇	ing
裏	okr
醮	gwu
虢	eam
龍	iwm
癣	pqu
踯	nug
內	kru
珐	ghv
颎	rud
馏	rtj
莛	sex
髭	hnr
龈	ntx
楹	fvb
钯	tc
虻	kuw
苌	sth
聽	agd
躅	nmw
牝	wri
钎	twk
畦	jhh
欤	sfe
桁	fra
腩	wdk
該	uoi
屍	bfr
蠹	dly
眬	mdq
夢	smy
張	vha
瓤	osr
淝	iwc
楫	fla
訇	wua
镊	tab
镗	tnh
樗	fdf
苫	sml
罅	wmq
涫	iob
螟	kyj
骝	xtj
連	gpd
蓿	soe
侉	egf
學	rww
厝	ssj
馐	rub
潍	ivw
兕	khw
黩	ndv
胪	wmb
诤	oyx
抟	asx
結	bhl
裝	xho
芪	sta
莳	sja
毽	rxa
筇	qfc
猞	rtr
砭	dqp
澧	iks
挈	dbt
怼	ba
镞	toq
貔	yrw
嬗	con
搠	aux
杷	fcb
薹	shl
並	ukg
铬	tel
讴	ogw
闼	pgp
歃	wre
輕	gfv
沆	ioq
箜	qpf
彀	hfv
傳	ega
荩	sbo
雠	wow
揿	ate
恂	ywj
茴	snl
國	ngl
衽	pen
鲈	qmb
紅	bfo
昴	jtm
缟	vol
廪	uon
垓	hoi
奁	ggw
瘙	pbo
讦	ohg
氖	qvj
葉	shf
铰	tot
陉	cbf
妯	cko
耄	hrr
菟	syl
镛	tux
鲧	qqb
峄	jba
竦	ifl
飨	vqy
鳏	qmk
猡	rmr
痼	pnd
讣	omo
殺	wfq
馕	rdl
枰	fhu
黼	kum
鲇	qml
酽	gau
歙	yxx
佤	eaw
妁	cwo
垩	auh
處	meq
锆	twl
枇	frr
鄞	gsc
乩	mlx
場	hjf
垭	hau
萁	sdj
伧	etv
盱	mfa
恚	hhy
鼋	fhl
钤	tto
兒	rqr
轉	gga
侪	ept
穑	rdu
極	fvl
煸	uin
砀	dvt
陣	cgc
蚋	kkt
吶	lkr
缁	vvj
颙	kdk
麂	iqj
猱	rcq
跸	nrr
岈	jhy
掮	aiw
沔	iax
趸	fwn
苣	sgb
萸	srt
裢	php
捭	awd
緊	sbb
雖	lkw
妣	crr
啁	lwh
誰	uwi
莴	slk
缌	vjy
鹬	cqk
夤	rof
玢	gtb
終	bes
镏	ttj
狯	rts
焐	ufc
魆	wgx
莜	sen
荇	sra
鲠	qfj
榉	fit
蚝	krm
楝	ffn
艨	qsy
棹	fmj
睃	mvt
瀣	imr
骐	xdj
筢	qac
靺	gho
磔	dra
柞	fqm
膂	oqr
鞨	gjw
锰	tvm
聃	akh
堞	hhf
蟥	ksk
薅	scs
墀	hbk
窳	pqq
呎	lbo
怿	yba
嵯	juf
艟	qik
蛳	kuf
迨	vlp
犰	ryf
跶	ngp
橛	fsu
篦	qrw
趺	ngu
倥	epf
瞇	mpp
鸹	rya
崃	jfp
旒	oqo
記	ubj
芡	sei
請	uhw
耧	dtp
眾	met
钴	tdg
欸	vqe
眙	mvl
耒	dti
缃	vfm
怛	yjf
逄	eap
哏	lvn
沤	igw
荨	sxa
圉	nhu
耋	hrh
雙	wwb
毂	hhc
俳	eli
铱	tor
薮	spc
崤	jws
峤	jet
貘	ysj
珮	gqf
笄	qfs
缗	vca
蹁	nin
秫	rfo
璁	gre
吋	lac
醪	gxx
庑	ufd
郿	bmc
莼	sva
筮	qft
挹	alc
阒	pms
媸	cxf
怫	yvt
鲔	qsw
許	uqd
疣	pdo
雱	dog
認	ubo
團	nga
镍	ttf
褫	pem
轳	hmb
锛	tgd
萬	sky
鲵	qrq
熵	uou
謝	uwa
馑	rgs
瘆	pvg
電	dkd
續	bhm
塄	hmo
纔	byl
涞	ifp
杼	fcu
沖	iln
崮	jn
岘	jkx
镢	tsu
诂	odg
玦	gbt
鲮	qht
氟	qvt
洄	inl
栊	fdq
孢	vwc
郏	guc
澶	ion
詈	mua
獬	ryt
興	rkf
鳃	qjy
線	bek
讵	ogb
枋	fog
鞣	gcq
澌	ide
啭	lhs
蜉	kev
樘	fnh
耦	dtk
跖	ndh
虛	mxf
蛉	kto
箪	quj
逋	fpd
璈	ghw
扦	awk
孃	cos
愆	ria
隊	cud
诔	odt
矇	msy
鲽	qhf
狳	rtf
髋	mos
毖	rry
槎	fuf
铙	taq
嫘	cjb
漯	ijb
骟	xix
墒	hou
蹚	nnh
阋	prq
牖	tif
刈	wmd
谝	oin
悭	yn
總	bre
鬲	flk
瓠	gfs
麸	heg
笮	qqm
圪	hqv
棰	fws
轾	hhk
衛	rca
砷	dke
杓	fwo
锱	tvj
餍	ssy
辦	oxo
疴	pal
寤	oxf
芎	svg
糍	puv
捩	ais
蹼	nku
鳕	qdx
缡	vpx
尻	byf
茑	sya
榫	fwd
幛	mij
秭	rqx
鲅	qsb
郜	wlc
殍	fre
樨	fbk
碇	dof
凼	kxg
蟮	kuu
炔	ubt
萘	sgh
蓍	shr
飧	rys
岢	jal
刿	jrm
痧	pim
蕖	sig
谰	opf
霈	dif
訴	ueo
唵	lgk
叆	sve
腦	wvr
钚	tdu
槲	fyt
聖	alg
痈	ptn
狷	rlw
酢	gqm
阍	pta
漸	ige
層	buj
準	iwd
傈	edf
怙	ydg
渌	ixk
癔	pij
莪	sqa
視	hmx
吽	lwn
腳	wtt
浞	inv
檩	fon
镠	txx
嘚	lrj
鸱	tao
盍	hvm
昉	jog
圍	nci
藥	sev
赉	fpk
霪	die
菏	sia
诹	oab
夠	rrw
苴	smi
粳	pfj
樹	fda
惡	fjy
義	uqa
護	usw
舸	qal
趵	nwo
笊	qek
畈	jeb
燠	urp
阊	pjj
鸬	mby
攮	adl
艿	svj
璘	gpr
椟	fdv
氦	qoi
笸	qgl
圮	hbj
醛	gst
佈	esm
谖	oeh
髡	hhw
枳	flt
懷	yom
則	mmd
髫	hbl
暾	jov
訾	nru
確	dyw
趕	djh
镒	tut
碛	dhk
缳	vmf
硖	dgu
溧	idf
柢	fta
镬	tsw
皴	vte
虼	kqv
軍	ygc
箝	qas
鋈	iew
帙	mqg
锞	tjf
樓	fld
泮	iua
觀	sll
眭	mhh
溱	igr
倆	efm
郯	uuc
隰	cjv
報	hud
約	bwo
尋	xfl
朐	wwl
跬	nhh
愀	yru
識	uig
嘡	lnh
毀	rhq
醚	gpp
鳜	qsu
恆	yfw
麇	irh
達	hup
遄	jsp
竑	isv
琤	gyx
趱	dwq
壞	hom
螅	kty
細	bjt
垸	hof
裎	plg
埸	hjw
玭	grr
槠	foh
顯	jvv
淚	iis
肽	wgo
盉	rmn
顸	hdk
褊	pin
鲟	qxa
帻	mhk
瘐	prt
簋	qvm
梃	fex
缵	vwq
屣	brn
缒	vyp
塊	hwu
炻	udh
絲	bbs
磴	dbf
锶	tjy
跣	nwq
練	bfn
迓	hpd
閃	kte
疖	pxj
炝	utv
鐘	wik
硒	ddx
啉	lff
汔	iqv
伛	egw
蛄	kdg
鞯	gss
绂	vsb
燹	ddu
翀	xxl
濬	imy
跗	nea
銀	wvn
凇	sft
綠	bbk
調	uwh
寫	orw
嗉	lhb
盡	xfu
饫	reo
辏	hgf
鼙	ddb
璩	gmd
沚	ini
純	bax
殘	frg
鲥	qja
褙	pur
煳	udw
笕	qkx
尥	dwo
劢	fwx
隻	wbu
轫	hbo
佾	etw
抺	ahe
棼	fft
熘	utj
萏	syr
媽	cdm
睏	mnf
響	vqo
喾	iyw
剡	uum
鍊	wfn
麴	dew
曩	jos
砗	dhc
髁	mjf
蚍	krr
阃	pnf
溲	irn
狺	rua
鲢	qhp
傑	era
燒	uhh
缑	veb
愦	ylk
疋	vnf
榧	fgl
蚜	khy
洫	iqm
蹾	nov
員	lmb
粜	xxp
螈	kse
踫	nuk
绨	vuv
抔	adu
庋	udb
胝	wta
計	udi
铍	tvp
跏	nxl
锔	tbv
蝣	koq
習	xxe
論	utf
柙	fkj
鸫	amy
罘	mdu
潲	irm
皤	eqp
笥	qvf
憶	yij
險	crl
鲱	qli
賣	hmm
溽	isa
伲	ebr
禮	hks
痦	pfc
狀	xs
屬	bkm
嘆	lsf
桿	fjh
鳎	qjx
滏	itw
廨	uyt
觳	hfy
戢	lag
羅	mbw
郛	evc
蓐	ssa
買	mmb
業	kut
锜	tga
郇	wjc
粝	psf
耜	dtb
鹩	guj
厲	ssk
鹪	wuy
髮	hsb
迴	nlp
埕	hlg
坼	heo
洳	icl
嫠	hes
尜	mgm
墁	hjm
廝	ude
埒	hea
脫	wtl
講	usk
蔟	soq
颟	sfk
劬	wlx
蹀	nhf
誘	urv
飄	dhr
係	eqb
谮	ogq
蠖	ksw
畀	jaj
紛	btb
蚬	kkx
镲	tow
郫	wdc
煩	udm
讚	uwq
嗍	lux
臜	wwq
阈	pgl
組	bmi
赜	shk
頂	adm
歲	ndf
鳐	qew
陔	coi
狁	rvq
矽	drk
擺	amv
汆	rkv
呣	lbm
磲	dig
呒	lfd
钼	tmf
蝰	kgh
劁	wum
肫	wax
眄	max
畋	jeh
崦	jgk
瘋	prf
酹	gea
慘	yvv
髒	msf
稱	rek
锑	tuv
暌	jbf
蟻	kuq
菔	swx
焓	uto
琍	grm
胙	wqm
旆	oqf
靸	gvo
畢	jsa
癒	ptf
簡	qkj
觇	mlk
碡	dhb
缣	vux
擔	ays
埽	hxy
谠	onq
丟	gvv
補	pfu
聯	avv
倖	ehu
統	bov
牆	xht
鞬	gxa
芟	sqh
鲷	qwh
踔	nmj
僳	edp
產	psw
討	uac
槭	fdk
鲞	ugq
紙	bta
蚴	kvx
桴	fev
囟	rwl
費	vtm
騙	din
疃	jik
燔	uqp
飑	qww
賓	ofm
琇	grv
幞	mku
唑	ltt
溴	its
俵	ehr
鲆	qhu
玡	ghy
掊	ail
畚	vgj
鮮	tug
塵	iht
質	eem
硗	daq
泖	itm
帥	ymv
隈	cjg
劉	twm
碚	dil
嵫	juv
怃	yfd
側	emm
罱	mdk
揮	ayg
捽	aot
採	aef
篥	qdf
設	uqh
虮	kqj
醢	gsl
陬	cab
埘	hja
羑	uyo
翚	xxy
锕	tca
櫻	fmm
負	ymb
砼	dtf
課	ujf
侔	evw
鏡	wij
豬	dhj
偉	eci
硃	dwt
擋	anj
牾	wfc
杪	fmq
籴	rpm
缧	vjb
訝	uhy
鬏	hru
揠	agj
畫	xhj
敗	meh
蓋	shv
诼	odo
鹆	ttl
議	uuq
畎	jsq
楯	fed
蛴	kpt
嗌	lut
詩	uha
嘌	ldh
萊	sdl
缬	vhl
圖	nld
賞	nmb
適	ouk
谇	oot
驗	drl
哕	ljr
罵	mdm
廛	ukt
丏	axv
袷	pye
烃	ubf
氚	qqc
黾	lkd
襻	pfw
铵	toc
躞	nuu
緣	bbd
環	gmf
镉	tfl
涼	iom
遘	skh
據	amd
诖	ohh
柽	fbh
绲	vjr
豨	dws
骯	moq
蹤	nrt
潔	idb
禊	hdb
圬	hfs
茌	seh
疔	pan
虿	fwk
睜	mex
呋	lgu
圓	nlm
铯	tyc
慄	ydf
洧	isw
垧	hrn
桕	frj
跡	npi
浯	ifc
橫	fss
惝	yns
蛞	kre
臨	sql
憐	ypr
牤	wuw
薷	sds
嫋	cvs
獄	rus
蚵	kal
爛	ukf
蕻	shs
蒗	sio
蚰	kko
罷	mvw
鳔	qdh
焜	ujr
骶	mta
圹	huu
霑	dim
徬	rou
鲀	qax
晡	jfu
湔	iuw
閉	kaq
聞	kar
歸	ynx
甾	vjt
篪	qem
島	rjs
權	fsl
維	bwi
蘋	snm
裥	ppj
紀	bbj
宮	olr
紮	fxb
枵	fls
笪	qjf
鲼	qds
沩	iox
绁	vhi
髌	moe
紡	bog
罾	muj
溻	ijx
蛏	kbh
蜱	kwd
稜	rht
莊	sxh
氆	ruk
餵	yjg
遙	wwp
勁	fvf
優	edw
樑	fib
蹟	nhm
爝	uem
敫	eoe
爺	twa
钒	tqo
鬆	hft
踬	ned
巖	jl
笾	qxp
铫	tqs
廢	ubv
曛	jwn
埝	hto
楦	fof
钍	tht
俠	egt
谂	oto
際	cwh
硭	dsu
茆	stm
炱	vlu
馇	rfj
菹	sim
蘭	skf
趑	dse
霧	dcq
屦	brp
詭	uys
玙	gsf
撲	aku
鳊	qin
軟	gei
棻	stb
濕	ijv
螽	esk
埤	hwd
蜩	kwh
莸	srd
憑	sdy
鞲	gsk
梿	fhp
導	utp
髹	hef
蓮	sgp
寧	oym
毪	rvw
洎	itk
卣	mnb
氘	qti
栳	fhr
煉	ufn
骒	xjf
廳	uag
災	vuo
揸	afj
纏	buk
織	big
籐	qwu
撐	anh
渫	ihf
劼	hlx
婦	cxy
邾	wtc
鬍	hdw
庫	ugc
縮	boe
堙	hdh
慮	mjy
紗	bmq
噍	lwu
複	pqj
喲	lbw
寬	osm
謎	upp
誤	ulf
喬	elk
紋	bpw
鞒	get
瀰	ivf
灑	ifk
薑	sfj
僅	egs
钋	tmo
嗪	lgr
穀	hfr
刭	bfm
蛘	kug
黪	nvg
遞	emp
攉	adw
钕	tcn
氩	qau
勗	jmx
損	alm
骀	xvl
垡	egh
缂	vge
霨	dbh
锇	tqa
肟	wfs
錄	wbk
籀	qat
瘰	pjb
仡	eqv
財	maq
砟	dqm
牂	xug
讀	uhm
傭	eux
嘗	nrj
嵛	jtf
詠	uok
瓿	ila
孫	vqb
礦	dus
煺	uvp
瘛	pdb
槔	feg
垌	hkf
忭	yoa
鬚	htd
龐	uiw
獴	rsy
蟛	kdt
辋	hku
嘧	loy
龠	ync
腠	wgf
儀	euq
氾	ivi
兇	wxq
殪	frh
詞	uvf
鞴	gsq
镘	tjm
穩	ref
唼	lic
捯	ahm
躍	nxx
胍	wqu
垚	hhh
烀	uqu
碼	ddm
檔	fnj
硐	dkf
遲	bkw
壯	xhf
輩	lgc
箢	qor
灣	iub
紹	bbl
檎	ftp
嘯	lxt
營	uuy
戽	isd
囧	ntk
苘	skl
廁	umm
甏	dta
盜	iem
鳴	lro
氡	qes
麵	deg
尷	dsq
嚄	lsw
瑯	gox
瘼	psj
軀	wgl
枧	fkx
諸	uhj
桤	fjb
柺	flx
積	rhm
铒	tar
鑑	wsq
湲	ieh
鲣	qnb
帳	mha
啟	ile
餓	yqa
痲	psi
坫	hml
夬	bte
閻	kyr
胂	wke
贏	umb
铪	tye
贶	klq
肅	xtx
訚	pua
簽	qrl
掃	axy
鹇	pfy
疬	psx
繃	bjw
橋	fel
靿	gvx
脈	wer
珧	gqs
眵	mrr
苈	ssx
钌	tvl
饹	rel
撥	abv
籃	qsq
坭	hbr
賺	mux
嵝	jpc
厍	shc
鄹	abe
儘	exf
躐	nvn
編	bin
訓	uqc
館	yob
跐	nnr
砘	dax
甦	fjw
縱	brt
綁	bdc
澤	imh
埯	hgk
飲	yei
堍	hyl
舊	swr
惱	yvr
舄	rwu
姪	chk
琯	gob
嬌	cel
暈	jyg
彎	ubb
硇	drw
駛	dlw
爐	umj
湯	ijf
虧	mwf
兗	otl
夼	gqc
迕	qdp
鲚	qpt
砜	dqw
拃	aqm
圊	nhw
淠	ija
臟	wsg
違	cpd
饸	rye
胨	wam
拤	akm
禍	hna
菪	sod
輛	gfm
箦	qhk
彌	vft
腈	whw
滗	iqr
奧	rqp
溝	isk
仉	eqj
镧	tpf
犏	win
縠	hfb
詛	umi
駕	xld
絶	byc
綑	bn
齉	tja
罈	wdj
鋒	wed
獲	rsw
暢	kjf
钫	tog
侶	elr
坌	tbh
潛	igq
梱	fnf
頹	rqd
臺	hly
褟	pjx
監	sqm
悅	ytl
铋	tyq
辭	ebk
縫	bed
胬	cbk
濤	ihv
潰	ilk
勳	wnx
繫	gxq
澉	iva
齋	oun
肼	wst
廂	ufm
簷	qys
鼯	rbf
闖	kdm
窮	pwv
棁	ful
枨	fth
鹛	bmy
鍾	wwk
捃	axq
燜	uky
罨	mgk
恓	ydx
訊	uvd
蒟	siw
酤	gdg
療	pgu
俬	erv
罰	mum
跞	ntm
媭	tdk
罽	msu
绗	vra
閑	kfv
闊	kir
蛸	kmw
廟	udj
韁	gfj
杻	fbc
撿	arl
崚	jht
蔭	sct
眍	mgw
搋	aem
緻	bhe
綿	bem
渾	iyg
芼	srm
墳	hds
嚕	ltj
兌	tlq
脅	xxx
蠅	kjm
泐	icx
賜	mjw
魯	tjr
荬	svs
眊	mrm
瘵	pwh
鎮	wdm
騷	dbo
挾	agt
檢	frl
運	ygp
揹	aur
嬝	cro
窺	pgm
迮	qmp
鶉	ovr
飽	ywc
跼	nbv
鵝	qag
瑪	gdm
驅	dgl
踺	nxa
窩	pna
炤	ubl
嗚	lyw
賀	xlm
竄	prb
脣	swy
譜	uuk
詢	uwj
殼	hfq
錶	whr
繩	bjm
攤	asf
鰭	thr
誅	uwt
併	eus
赇	kfk
儲	euh
睪	mhu
築	qfq
閱	ktl
頁	dmb
慶	ivy
龜	qjm
鬱	fwf
楓	frf
摟	ald
評	uhu
糾	bxg
鱗	tpr
馳	dcy
爍	uev
镓	tod
納	bkt
謔	umx
賦	mfg
縛	bfa
蝕	ykc
黨	nne
攴	mbu
週	whl
燻	uwn
鳢	qks
鳙	qux
饒	yhh
菴	sgk
螵	kdh
嶽	jru
鍋	wna
壇	hon
闢	kbl
稅	rtl
諷	urf
償	enm
億	eij
噓	lmx
鋼	wku
曬	jfk
誇	ugf
籤	qtt
呂	lrn
闔	khv
狹	rgt
飼	yvf
購	msk
誕	uqn
嘖	lhm
鏈	wgp
潑	ibv
侷	ebv
郵	wsf
絡	bel
擬	arq
疊	jjj
蔣	sxw
骣	xbv
輔	gfu
審	oqp
筍	qwj
邁	skp
犋	wmt
蘇	str
軌	gyf
彙	byj
搗	arj
鴦	kgr
篛	qvs
耠	dty
嚆	lso
賊	mgs
鳓	qgx
萜	smm
朧	wiw
艙	qto
洶	iww
穌	trh
賢	sbm
巘	jmf
蔥	sre
譽	rsk
滄	ito
闋	kbf
鑰	wyn
蒐	swu
轅	ghl
柈	fua
曠	jus
鹹	kdf
慍	ynt
渦	ina
窪	pih
債	ehm
漲	ivh
覷	mkm
纖	btt
祙	hhe
粞	pdx
矓	miw
駭	doi
噠	lhu
綱	bku
韻	ijl
膦	wpr
懇	yvy
铟	tng
寵	oiw
嚨	liw
襯	pif
燦	umr
縣	mmq
擴	aus
獰	roy
嬤	cpv
漁	ity
醃	ggk
鈕	wbc
篤	qdm
攔	akf
挦	axa
狽	rmb
铌	tbr
瓏	giw
僱	eiw
屜	brh
辮	obo
絨	bgs
餅	yus
屆	bhx
釀	gos
莖	sfv
蘿	smb
簑	qof
镩	tpl
揳	adb
葦	sci
茓	spx
賠	mil
衆	qme
燼	uxf
嵎	jky
譯	umh
弔	vns
釘	wan
愜	ygg
錘	wws
枴	flb
嵖	jfj
瑋	gci
猙	rex
蝽	kgj
籠	qiw
縷	bld
铼	tfp
牁	xal
姦	ccc
犧	wur
蘊	sbn
蠶	gqg
滪	icd
嵐	jrf
輟	gbb
磚	dga
紈	byo
鴉	hro
淵	itx
釣	wwo
譎	ucq
禪	hll
綵	bef
樸	fku
穢	rnd
脹	wha
槓	ffm
鼢	rbt
韓	djc
盃	dmn
蝦	kbs
綢	bwh
塆	hpv
囑	lbk
壺	hyj
詐	uqm
燐	upr
膠	wxx
趨	dwx
梟	rfv
悵	yha
鍛	wef
絞	bot
攙	ayl
錐	wwi
僕	eku
絆	bua
諧	urr
齪	mnv
釵	wbo
攪	arw
崗	jku
膙	wvl
瑣	gmm
盞	ggm
齬	mfc
嘔	lgl
鵬	wwr
緬	bgi
醬	xwa
緝	bla
繚	bgu
贖	mhm
繽	bof
潟	irw
欽	wei
曇	jds
鞡	gai
镵	tyl
脒	wpm
廚	uda
鴨	kro
氳	qnt
鐺	wnj
鹐	yry
颯	irf
誼	uom
娛	clx
峽	jgt
妝	xcn
髏	mld
輯	gla
淺	igg
薦	sis
姍	cnc
覓	emx
喫	ldb
稃	rev
遷	dgc
躪	nsk
鞦	gru
鏟	wiq
矚	mbk
喹	lgh
缽	wff
綣	bug
齣	mwl
貢	fmb
綺	bga
鶴	ywr
靂	dsr
畝	ojy
馴	dqc
媼	cnt
漣	igp
芻	wxw
憫	ykp
箇	qnd
繡	bxt
蘆	smj
揀	afn
綽	bmj
颳	rre
卹	qmx
壎	hwn
餚	yws
繪	btf
幀	mmm
燭	umw
闌	kfn
絢	bwj
椪	fuk
鬨	nst
靄	duj
廠	une
絹	blw
铷	tcl
鹽	sqk
瓊	gyk
綜	boh
隕	clm
譴	ulk
紐	bbc
錦	wem
囁	laa
牀	xfv
繭	skn
瀝	isr
馱	dgd
鑲	wos
噥	lks
澱	ibs
隸	fhx
虜	mjx
懺	ytt
踐	ngg
籌	qhv
摳	agl
頃	rdm
櫂	fxx
搾	apq
嶼	jrs
螋	krn
諏	uab
裊	ror
陝	cgr
欖	fsq
襪	psm
糰	png
驃	ddh
韌	cbo
鉅	wgb
铈	tom
紳	bke
睞	mdl
駟	dnq
鵑	lwr
褻	oht
匜	gcy
齶	mll
瀆	ihm
慚	yge
滌	ien
腎	sbw
縊	but
柵	fnc
澗	ikj
鴿	yro
詰	uhl
僞	eew
諱	uci
銜	rwa
誠	udv
鋸	wbd
覬	jfl
暘	jjf
貿	tmb
蠔	kod
謅	uwx
斕	pkf
躱	wvf
誥	uwl
竇	phm
藪	sld
輿	rgf
閘	kkj
鴛	rvr
輻	gfl
鉗	wss
鏤	wld
纴	ven
螻	kld
驢	dmj
驛	dmh
儂	eks
輓	gyl
繾	blk
繳	beo
緘	bdf
絝	bgf
礫	dev
滷	ikl
駑	cbd
軔	gbo
縐	bwx
覈	deo
擰	aoy
聶	aaa
僑	eel
繹	bmh
緯	bci
攬	asq
皚	ejf
餌	yar
軸	gko
鸚	mmc
濘	ioy
嶄	jge
誨	uqb
誒	uvq
讖	utt
朶	vfv
訐	uhg
餉	yrn
嚶	lmm
貲	nrm
賄	msw
襠	pnj
癘	psk
篩	qyf
鍬	wru
鋤	wmx
莢	sgt
憲	odm
臚	wmj
鉛	wql
鑣	wiu
犢	whm
轡	bgb
儉	erl
櫥	fud
鷂	ewr
貳	gsm
韜	cer
卽	erx
匱	glk
殯	fro
檸	foy
摑	ang
磯	dvv
賁	dsm
濾	imj
貸	egm
贓	mgx
囌	lst
龕	yiw
囈	lsh
饅	yjm
銻	wuv
誣	uft
鴆	yqr
幟	mig
餡	yyr
齟	mmi
魷	tdo
輒	gax
轂	hfg
嬪	cof
嶇	jgl
闕	kux
崟	jwj
訃	umo
囀	lgg
詫	uoq
鳶	gro
鈉	wkt
矯	qel
嫻	ckf
馮	sdm
籲	qyn
蓽	sjs
踴	nbt
萵	sna
嬈	chh
踒	nrc
紉	bbo
儔	ehv
綾	bht
繮	bfj
櫝	fhm
醞	gnt
緇	bvj
鴣	dro
奩	ggl
紼	bvt
綰	bob
韃	ghu
琺	gih
歿	frw
縟	bsa
廡	uqs
詼	usu
闈	kci
嶗	juu
甽	jqc
鉻	wel
閏	kgn
諍	uyx
鹼	krl
蝸	kna
襖	prp
颶	rmt
玅	ovm
跥	nvf
圇	ntf
藺	skw
鸻	ray
簫	qxt
幗	mng
铻	tfc
葷	syg
賑	msn
躥	npr
躊	nhv
蘚	stu
齦	mvn
鑠	wev
壙	hus
騾	djb
餾	ytj
疇	jhv
鈾	wko
鎢	wyw
錚	wyx
懍	yon
愾	yqp
鍍	wus
驪	dfk
櫛	fqx
䦃	tsh
讒	uyl
詮	utg
謨	usj
訖	uqv
諺	uiq
詁	udg
䥽	txb
鱸	tmj
襤	psq
牘	thm
鰱	tgp
鱷	tgl
蓀	svq
蕪	sqs
稈	rjh
鼴	rbg
簍	qld
鈣	waf
鉑	web
鐃	whh
鏍	wjb
愴	yto
飭	yqx
奐	ykt
飪	yen
餒	yec
飩	yax
銖	wwt
錳	wvm
銓	wtg
鎳	wtf
䏝	wsx
鑊	wsw
鈽	wsm
釧	wqc
鋅	wox
鏃	woq
鏝	wjm
糉	pwx
褸	pld
墾	yvh
縑	bux
倀	eha
驥	dur
硯	dmx
駙	dea
嬋	cll
隴	ciw
嫗	cgl
綞	bws
纜	bsq
齲	mql
紇	bqv
締	bou
縲	bjb
綏	bec
鷥	bbr
紂	bac
捫	akn
㧟	aig
傯	ere
曁	erg
傖	eto
貯	moa
螄	kyf
蟈	kng
閆	kfa
崢	jex
塢	hyw
壢	hsr
琿	gyg
軋	gxi
輜	gvj
鵪	gkr
轆	gil
輊	ghk
軾	ggf
璦	gey
櫚	fkl
饈	yub
㤘	yyx
用	tnn
三	faa
却	hvxj
觉	iykx
白	ebb
完	ofhw
原	sema
使	eflw
车	hcc
黑	nee
至	hkk
哥	alal
落	siel
言	uaa
武	fgni
房	ioge
周	whlv
交	otwl
领	tobk
千	wkk
官	obbu
求	fkod
楚	ffvn
易	jwto
足	nvv
院	cofh
丽	fkkf
呼	lqua
七	aii
热	ayou
古	dgg
旁	ouyo
争	yxvi
念	tovy
木	fvv
游	ioqv
激	ieoe
巴	cbb
商	oukl
讲	osti
份	etbd
示	hss
器	llsl
皮	vpp
靠	wlli
幸	hudi
毛	rmm
板	febu
缓	vehb
耳	arr
警	swlu
宫	ollv
吸	lvod
沙	imqp
救	fkoe
春	gjru
察	owhs
充	ovqr
贵	lkkb
座	utth
险	ctfi
超	dblv
麻	paa
营	syll
食	yss
欲	ttle
厉	sfwy
萧	sxtt
田	jtt
混	ijrr
透	rvpd
休	efve
技	adbu
兽	ujfl
街	rhha
浪	iovn
尚	nss
弱	vsvs
雄	svwi
赛	ostk
施	oqcy
墙	hdul
牙	hyy
魂	svwu
蒙	syfd
鱼	qyy
亡	uww
灭	fuoi
危	ysvi
盘	qmno
彩	efto
挂	ahht
惜	ysjr
创	tvmd
硬	dfjw
拳	ugtu
采	efvk
敬	swle
弃	ovsj
俊	evte
列	frmd
劳	syxk
谓	ojwy
尸	bhh
残	frfg
俩	efkt
项	fdkb
户	iee
横	fskt
范	sivi
律	rxao
番	qpjt
聚	abes
含	tovl
预	cdkb
沈	iyqr
批	arri
诚	odvi
疼	pesi
漫	ijmb
吐	lhtv
谷	ttlv
凝	srqn
鼓	ddbu
席	usfm
塞	osth
闷	pyin
稳	ryxy
诺	ossl
爆	ujsk
鼻	tjaj
慌	ysuq
愤	ydsk
怜	ytob
郑	ugcj
逼	fljp
县	mvvi
执	ayod
荣	syfv
庆	ugdu
遗	lkkp
慕	sjgo
皱	yxvp
幕	sjgm
壁	bloh
涌	ibtn
怨	rvyi
拼	ausj
迫	epdb
莉	srmd
嗯	lngy
佳	ehht
旅	oqry
胖	wuao
傅	efac
堆	hwit
裂	frmr
遭	sjjp
赤	htti
浮	ievk
匆	wtod
乌	eww
丰	dnn
竹	qkk
轰	hbbu
哎	lswl
额	oelk
唇	slvn
暂	hejr
慰	bhay
蛇	kori
悠	eney
途	tffp
洪	isti
冬	esih
甜	rssi
琳	gffv
乃	vjj
暖	jehb
坦	hjfi
萨	sciq
潜	iggj
朗	oxvw
滴	ioud
缩	voej
翔	uxxi
倾	erdk
厂	shh
董	swkk
埋	hkkt
乖	wuri
潮	idjw
末	hoo
盗	semn
侍	ehac
款	hhei
搭	asye
俗	ettl
融	flkk
喃	ldkd
乘	ruri
岳	efjs
减	sdfl
弯	pvgi
恭	stmo
皆	rreb
爽	gwww
亏	fski
吞	fglv
哀	oryl
汤	ivto
赫	httt
麦	hehf
枝	fdbu
弓	vgg
垂	wsfi
冥	yjot
逸	ylqp
均	hwsi
碗	dorv
航	qoqj
啸	lxtt
龄	ntxb
舌	ree
霞	dbsb
泡	iwck
盾	edmf
羊	ugg
倩	ehwy
喷	ldsk
拦	ausi
嘉	dxlv
殊	frwt
辰	snn
繁	qbeb
抛	ayxk
虫	kcc
献	dkus
媚	cbmf
葛	sjwx
摔	aovd
筑	qfqo
斜	tffd
瓦	aww
涂	itff
莎	simq
猎	rsjr
刑	fsmd
娃	chht
豆	flue
瓜	quu
莹	sygo
滋	iuvv
铃	ttob
拨	axbo
砍	deih
截	dgwi
愈	tfwy
督	kmbm
糟	psjj
腹	wqje
掏	awwo
夸	gfsk
液	ioeo
柱	fogn
堡	elfh
爵	emxa
穴	pxx
培	hilv
井	stii
卢	mbho
陶	cwwo
僵	efjf
疗	pvlb
泛	iqpe
齿	ntxg
扩	auuo
厨	sfla
劈	blob
尬	dtti
尴	dnqm
巾	mvv
描	asjt
绵	vemv
催	ejwi
辱	sacn
寸	acc
搂	apcn
欠	eii
售	wlvi
巡	vpdc
丛	ttfi
刃	bodd
蕾	sdjt
违	avpd
灾	ouob
雕	whlw
辣	oflv
刷	bmmd
夕	rkk
捏	ajht
谅	ooma
串	llns
涉	inma
鹏	wwya
姜	ucng
荷	seal
申	kee
割	odlm
棒	fgao
遮	usfp
矿	duuh
爪	ekk
础	dxxg
曰	jee
淫	ieen
亭	oanl
邀	eoep
哄	lsti
墓	sjgh
棍	fjrr
绳	vlkd
频	nmdk
添	ifgo
津	ixao
耻	anir
挽	aylq
页	dkbh
牲	wwgn
兼	uxnt
戈	ggg
寨	ostf
漆	iftk
枚	fehv
馨	hbqj
楠	fdkd
昆	jrri
逗	flup
蹲	nuga
逢	edpd
韵	ijws
谦	ouxt
兔	ylqo
订	oana
斤	ejj
芬	stbd
崖	jshh
颖	rrdk
娶	abcn
涨	ivth
藤	swuk
糖	puxl
彬	ffto
翰	djtx
眸	mvwn
谎	osuq
棵	fjfv
狄	ruoq
宛	orvi
憾	ydfy
偿	ensv
瑰	gwun
戚	dkma
郡	xqlc
澡	illf
邻	tobc
卜	moo
烁	utma
鹿	ill
溃	ilkk
朕	wugd
舟	qoo
妆	ucne
胎	wvlv
淑	ikmb
叉	bodu
弦	vovo
刮	rmde
囊	dlyr
黛	egne
狸	rkkq
叙	tffb
叠	bbbm
遣	lkbp
遵	ugap
塑	uxwh
蹦	njww
寡	odmb
赋	kfgn
匙	jfnr
竭	ijwx
讽	oqwl
辽	vpdl
嗦	ldyb
祈	hejs
栋	fama
吱	ldbu
禅	hujd
倦	eugv
靖	ihwy
惩	rfny
甫	fuu
姥	chri
熬	hweu
丐	afxi
茜	sdxj
彤	woto
彦	iqto
剪	uwmb
岭	jtob
罕	ythg
债	ehkb
倚	egal
隶	xkvl
拱	asti
裕	pttl
嘀	loud
沸	ivti
憋	umty
烫	ivtu
摧	ajwi
饼	rusj
狭	rgue
丸	yodf
楞	fmog
谱	oukj
肺	wfmv
兹	uvvo
弘	vvvg
盐	hmmn
滔	ierj
邱	efcj
桐	fkfl
翘	aqhx
郝	httc
睹	mhjr
郊	otwc
凳	bflq
淮	iwis
蔽	sume
潭	idjd
焉	fnsu
厦	sdme
蕴	svjm
薪	sife
荐	ssnv
秃	rqjh
磕	dhvm
坎	heit
暇	jbsb
醋	gsjr
衍	riah
嘎	ldmg
莽	sssj
汝	icns
暮	sjgj
澜	ipfu
钧	twsi
眶	mggn
乙	vii
丞	vkfi
梭	fvte
瀚	idjx
敛	tfie
嗔	ldmt
虏	mxku
陀	cori
哆	lrrk
垫	ayoh
鹅	qagy
狞	roan
诊	otto
霆	dexn
贷	egkb
吭	loqj
淘	iwwo
辟	blox
嗽	lfle
兀	hww
樊	fwwg
棚	fwwy
倏	enes
杏	flvv
赠	kujj
歼	frwk
襄	osry
惕	yjwt
敖	hweh
蝉	kujd
炫	uovo
膜	wsjg
蜡	ksjr
豁	odll
垒	vvvh
琦	ggal
孽	syov
毯	ruuo
挟	ague
祁	hcjs
矢	qii
朽	fskv
莺	syya
侮	eqbm
闺	phht
夭	eoo
苟	swlv
琉	govq
沛	ifmv
噜	lqjr
颓	rqdk
幢	mikk
诅	omia
拭	agfo
剿	vjfm
垮	hgfs
歆	ijei
拙	axxg
扳	aebu
擂	adjt
涡	ilkt
沌	iaxg
犀	bkwn
哉	dglv
瓣	oqox
婿	cvnw
葫	sdwy
诵	obtn
遁	edmp
讥	oqja
剔	jwtm
敷	foeh
喳	lfjf
搀	ayls
撩	agum
擎	swlt
寥	oxxt
弊	umts
呛	ltvi
亢	oqjb
呸	ldfi
顷	rdkb
踉	novn
嗖	lrnb
堤	hjfn
憨	vaey
僚	egum
晖	jyhc
窘	pxql
嵌	jsse
婪	ffcn
辖	hodl
酱	urgo
髓	msfp
淳	iovk
菱	shte
囔	ldlr
朔	uxwy
憔	ywuo
臀	bstw
伶	etob
厄	svih
雳	dsxk
卵	tood
檐	fysu
炕	uoqj
蝎	kjwx
幺	voo
舵	qori
椒	fkmb
厘	skkh
疙	pqvi
芠	spwj
匿	gssl
挚	ayot
镯	tmwk
尧	aqhw
狙	rmiq
辫	ovox
瀑	ijsk
庐	uieu
禾	rhh
湛	idxi
蒲	sifu
贬	kqpe
惮	yujd
嗒	lsye
慷	yuxk
穹	pvgx
嬴	ucnw
袅	yory
淇	idjs
赦	htte
榻	fjxx
唰	lbmm
庶	usfu
邸	taoc
漱	ifle
谬	oxxt
蟒	ksss
棱	fhte
悚	yflv
佬	ehri
倡	ejjr
筠	qhws
蜷	kugv
癌	pllj
牡	whtn
懵	ysmm
诫	ogsj
氧	qugq
贿	kswy
肮	woqj
璧	bloo
攥	aqmb
巩	fqod
彰	ijto
漩	ioqn
聆	atob
蒜	shhs
棕	fohs
搐	aovj
怦	yhue
撰	acct
炙	wuoy
翎	tobx
栩	fxxi
逾	tfwp
褪	pvpd
鑫	wwwj
灶	uhto
祯	hmkb
韶	ijbl
缎	vefq
遏	jwtp
募	sjgx
奠	uggd
秽	rjrk
揖	alar
榆	ftfm
簌	qfle
蓓	seil
庇	urri
檀	fonf
枭	yfva
崭	jhej
掂	auml
醇	govk
槽	fsjj
镰	tuut
删	wwfm
鸳	rvya
酣	gssi
琅	govn
焱	uuuo
飙	sssw
栅	fwwf
猝	rotd
肴	wswy
侈	errk
俭	etfi
亥	oii
譬	blou
饺	rotw
讼	otvv
弈	psji
瘸	pxlt
傀	ewue
懿	hyfy
羁	mgxm
恃	yhac
儡	ejjj
呦	lvxk
烬	ubos
哒	lgpd
冽	sfrm
辗	hbsg
翟	xxwi
瑛	gskg
剃	uvnm
勘	dxxk
渝	itfm
鹫	omdy
娲	clkt
绫	vhte
阑	pfnu
炜	uavi
娼	cjjr
翡	lxxi
坝	hkbt
铐	thsk
敝	umte
靳	geje
裘	fkor
膳	wuul
忒	gyiy
谏	ofnu
羹	uuug
沥	isxk
饷	rrns
熠	uxxe
鲨	imqq
惴	yjsr
胯	wgfs
攸	eneh
锄	tmxk
硝	dmwy
颔	tovk
鸥	gwya
滕	wugk
蕉	swuo
垢	hefl
楷	frre
褒	oelr
孰	ovyo
啜	lbbb
晾	joma
茎	sbfo
隧	cudp
掳	amxk
莞	sofh
瓢	dhqu
锯	tbdg
猖	rjjr
殉	frwj
诩	oxxi
窖	pwlv
乒	efqp
淤	iots
凋	swhl
泌	iyqp
樵	fwuo
挎	agfs
羔	uuog
殃	frkg
淼	kkkv
淀	iofn
缨	vkkc
摁	angy
來	dll
睦	mhth
喵	lsjt
诶	ovqi
墩	hove
诲	oqbm
浏	ipmd
剁	qfmd
捻	atoy
娓	cbrm
璀	gjwi
苔	svlv
吮	lvqr
帷	mwiv
箍	qagm
梗	ffjw
瞿	mmwi
唏	lwsm
鲤	qkky
羲	urgs
苞	swck
犁	rmwn
掣	wkmt
谧	oyqm
纬	vavi
嘤	lkkc
藻	silf
钵	tffi
瑀	gqlk
佼	eotw
龌	ntxh
痰	puuo
簧	qskt
潺	ibvv
筏	qegg
瞌	mhvm
髻	hhlv
龊	ntxn
幡	mqpj
翌	xxid
闽	pkcn
鼾	tjah
桔	fhlv
抉	abte
蜻	khwy
碾	dbsg
哐	lggn
啐	lotd
鳖	umtq
坷	halv
冢	ydod
撬	arrr
澹	iysu
亘	fjfi
缇	vjfn
羚	utob
桨	urfv
噤	lffh
跚	nwwf
袒	pjfi
浣	iofh
榄	fnqk
荼	stff
晗	jtol
阉	pgkd
腋	woeo
炬	ugbu
渲	ioff
湮	idht
埔	hfut
噘	lsue
鳌	hweq
搪	auxl
膺	ueww
皋	egdi
呓	lsvi
淅	ifej
壑	myfh
挛	ptui
琰	guuo
佗	eori
戬	aujg
邂	ytbp
臊	wllf
藕	sdtk
湄	ibmf
癞	pflk
獒	hwes
吒	lqai
痉	pbfo
椰	facj
粱	ibtp
辐	hflj
渭	ijwy
蜴	kjwt
卯	tmm
骜	hwex
孚	evkk
禺	kyy
掖	aoeo
畸	jgal
晔	jerd
菡	svkx
噶	lsjx
坍	hwob
滤	imyi
俸	egao
蟠	kqpj
弋	gyy
馀	rtff
滢	isyo
珅	gken
徙	rnnf
瘴	pijd
嗝	lfln
泞	ioan
赣	ijek
鹦	kkcy
揩	arre
褶	pxxe
飚	qwuu
剐	lktm
鸠	yyaf
娑	imqc
巳	ckk
猬	rjwy
酪	gelv
隼	wdii
婠	cobb
盹	maxg
轧	hxic
龇	ntxr
掸	aujd
趄	dmik
皖	eofh
邺	kcjg
鹉	fgny
匍	wfuy
幔	mjmb
蝈	kngo
偃	egjc
侬	eyry
搡	abbf
袂	pbte
洵	iwjr
摹	sjgt
邋	vnwp
瓒	gwqk
苻	seac
泗	inqr
痣	phyi
谤	oouo
蟋	kqpy
浒	ioqd
愠	yjmn
呤	ltob
宓	oyqp
忪	ytvv
遢	jxxp
孵	toov
讹	oeri
颀	edkb
苓	stob
咝	lvvf
揄	atfm
嗑	lhvm
犷	ruuq
荔	sxxx
闫	pfan
徵	rfgn
馍	rsjg
楣	fbmf
蜃	skcn
戌	dfiw
匮	glkk
啻	ouyl
跂	ndbu
摒	abus
峪	jttl
菠	sivp
蓟	sqmd
燮	uuub
氲	qjmn
湍	ijsr
殡	frot
毗	jrri
瘁	potd
蔻	sofb
锚	tsjt
濑	iflk
耘	dtsv
裟	imqr
苒	skht
掇	abbb
阏	pots
塾	ovyh
衩	pbod
戊	dww
犟	vlkw
酉	goo
斡	djtd
潢	iskt
轼	hgfo
嘹	lgum
時	jhac
璎	gkkc
觎	tfwk
浚	ivte
臼	rjj
蹩	umtn
罔	kuuw
堑	heht
箴	qdfl
嵘	jsyf
艮	vnn
葆	self
還	mflp
锷	tlls
爻	wwll
贰	gskb
坳	hvxk
昀	jwsi
壬	enn
淬	iotd
恹	yssq
酵	ghvk
孛	dyvk
茱	swti
孪	pvki
泠	itob
鲲	qjrr
闾	pllv
谟	osjg
翦	uwmx
糠	puxk
旮	yjrf
峋	jwjr
飛	bkk
潸	iffw
喟	ljwy
囱	rehn
铳	tovq
兖	otvq
栾	pfvi
畿	vvgj
诌	oyxl
赓	uxtk
谲	ocql
泾	ibfo
绔	vgfs
樣	fuok
馄	rjrr
粲	mrbp
剜	orvm
蜚	lkci
殒	frlk
浃	igue
颚	llfk
無	qsfu
彗	ddxl
赧	httb
佝	ewlv
蒯	swwm
郦	fkkc
硅	dhht
纂	qmgb
萋	sdxc
熨	bhau
觐	gskx
阗	pdmt
泫	iovo
迳	bfpd
彧	glft
漕	isjj
饯	rfgg
噻	losh
颧	sllk
颢	jomk
郢	lgcj
珪	ghht
璜	gskt
聒	arer
禛	hdmt
鹜	cqey
翕	yxxi
鳗	qjmb
踊	nbtn
骊	xfkk
皈	eebu
孑	vfil
帼	mngo
篑	qlkk
潋	itfe
遨	hwep
锺	twkk
邈	yeqp
俪	efkk
铉	tovo
茁	sxxg
榔	foxc
娩	cylq
呶	lcbu
呯	lhue
饬	rqxk
壹	hyfu
鹂	fkky
戕	xggp
埂	hfjw
倢	efxn
奂	ykgd
猊	rrqr
钛	tgod
葩	secb
傕	eywi
磺	dskt
汕	ijss
蠡	bdkk
剎	wfom
肛	wfoy
桠	faue
郃	ycje
氐	taod
妺	chon
哙	ltsv
喙	lbds
褓	pelf
赊	kths
鄱	qpjc
嫫	csjg
瓴	toba
螓	kgrh
镌	twvj
麗	fkfi
谡	ojte
雎	mwii
砥	dtao
衢	rmma
骞	ostx
狒	rvti
栎	ftma
拮	ahlv
掴	ango
蘩	sqbb
禩	hjst
乜	cyyy
殓	frti
殛	frvf
疹	ptto
鸵	yori
韫	avjm
炁	gquo
懋	fcqy
佃	ejte
赡	kysu
鹗	llfy
铄	ttma
饽	rdyv
佥	tfis
尕	vmaj
逡	vtep
荥	sykv
郓	yhcj
诰	owlv
睢	mwif
蹇	ostn
縯	boft
間	kjrn
槊	uxwf
瑗	gehb
秸	rhlv
舐	rtai
谶	ottf
芈	saoj
邝	ucju
暨	xvgf
狻	rvte
滟	idyc
锟	tjrr
粑	pcbm
氅	nerm
鹑	ovya
聲	hbqa
橇	frrr
痢	prmd
柑	fssi
婳	cfjx
庖	uwck
俎	ttmi
墉	huxw
闇	kijr
哞	lvwn
旃	oqwo
锨	teei
長	haa
豢	ugds
绌	vxxg
蓑	sofr
殁	frqh
讫	oqvi
濛	isyd
蜇	aekc
殄	frtt
萼	slls
覺	rwwm
诮	omwy
緂	buuo
瘌	pflm
钜	tgbu
瘀	pots
婥	cmjd
赟	pfgk
祇	htai
鹧	usfy
掼	abdk
礽	hvjs
體	mksu
汨	ijrs
醍	gjfn
磬	hbqd
泷	idqp
铂	tebj
祜	hdgs
摺	axxe
豌	fluv
杲	jfvr
涝	isyx
魍	wkuu
跎	nori
锉	ttth
喆	hlhl
镁	tugd
邳	dfcj
痂	pxlv
醐	gdwy
愎	yqje
赝	sewk
禇	hhjr
裾	pbdg
椁	fovk
唿	lwty
澍	idac
崧	jftv
淩	ihte
衾	tovr
勖	ksmx
咭	lhlv
羸	uugw
谪	ooud
窣	potd
狲	rvma
槃	qqfv
戡	dxgg
嬅	csfd
濯	ixxw
莅	seid
懔	yonh
肊	wviy
誊	ugua
鳝	quul
見	mxx
卻	ttlx
韪	jfnv
嫪	cxxt
燏	ucql
俚	ekke
椤	fmrk
淖	imjd
聩	alkk
喑	lijr
遒	ugpd
痨	psyx
佫	eelv
蚡	ktbd
肜	wtoy
沨	iqwl
棫	fglf
诓	oggn
忝	fgmo
芃	sqod
珥	garn
酃	dllc
與	rskt
逦	fkkp
冁	ujdg
鸷	ayoy
莠	srvj
茔	syht
槚	fdkb
變	ubbe
狍	rwck
埙	hlkb
苕	sblv
貉	yelv
婺	cqec
糨	pvlk
铖	tdvi
镝	toud
轸	htto
將	xwac
黍	rtkv
馔	rcct
碁	ddhj
槿	fgsi
赭	httj
涪	iilv
酡	gori
傣	egkv
媞	cjfn
浜	ieft
暻	jjom
衿	ptov
郅	hcjk
疱	pwck
橐	dlyf
枸	fwlv
爿	xpp
進	wpdi
唢	lmkb
旸	jvto
窠	pjfv
嗄	ldme
卅	sss
苡	sxot
囹	ntob
毐	hbso
靈	dllt
疽	pmib
珙	gsti
诟	oefl
鬣	hvnb
黒	kuok
楂	ffjf
氮	quuo
箓	qxkv
勐	vmxk
谔	olls
碣	djwx
逑	fkop
褡	psye
矠	cqsj
蚺	kkht
綮	iebs
遴	prap
阄	pykd
荚	sgue
鎏	iovw
迡	brpd
郗	wsmc
豸	ykk
儋	eysu
瑸	goet
凫	yqja
纛	hbmb
滿	isfr
難	sflw
葻	srfj
诒	ovlv
酆	jddc
锒	tovn
贽	ayok
菖	sjjr
灞	idgw
珺	gxql
吖	luns
鸶	vvfy
亳	oqai
應	uewy
薨	smyr
祂	hcys
陟	cnma
炰	wcuo
靜	hwev
阆	povn
莒	sllv
稹	rdmt
豕	dss
苎	sofi
祧	hqss
擘	blot
犴	rhgq
玎	gann
仝	tfoe
邰	vlcj
赍	dttk
龅	ntxc
霂	difv
鬈	hugv
烺	uovn
忺	yeii
腱	wxax
醴	gksu
杌	fhwv
風	rff
拊	aeac
機	fvvt
蝮	kqje
晞	jwsm
飏	qwvt
烷	uofh
燊	uuuf
吔	lcyv
癯	pmmw
備	esqt
闿	pjbj
圻	hejt
痫	ppfv
黟	nrrk
矾	dqod
烯	uwsm
強	vvkc
踟	nqlv
镱	tijy
搦	avss
吡	lrri
荭	svfo
龢	ynrh
鯶	tygc
檫	fowh
鄯	uulc
氂	hesr
垅	hdqp
骘	cnmx
頫	qssm
蠃	ukcw
幂	yjgm
遠	hlrp
蟊	cqkk
沭	ifod
綪	bhwy
鹳	slly
苁	stte
門	knn
矬	qtth
帑	cbmv
關	kvvx
劍	rmdl
車	gcc
離	pxkw
溦	ijfe
脶	wlkt
娌	ckkn
孳	uvvv
脔	pktt
箬	qssl
豔	jddm
樯	fdul
糸	bss
甑	ujua
榘	qgbf
芾	sfmv
龃	ntxm
炆	upwo
涘	ivqi
蹰	nsfa
冄	ksif
郧	lkcj
嫇	cyjt
謇	ostu
湉	iyre
笫	qqxq
枞	ftte
禟	huxl
疥	ptti
氰	qhwy
驚	swld
蒹	suxt
檑	fdjt
禳	hosr
婄	cilv
勣	hmxk
馬	dmm
傢	eods
屃	bkbh
縻	pbsa
腭	wlls
鲑	qhht
淦	iwjs
洹	ifjf
砦	nrdh
楸	fruo
鹈	uvny
昇	jqsj
鬻	vpvn
東	fjrv
龉	ntxl
庥	uefv
囗	nww
柝	feod
堀	hbxx
谘	osel
泔	issi
協	dxxx
徂	rmic
羕	uokv
彘	brqr
荜	srrd
儁	ewkf
焯	umjd
椋	foma
芩	stov
蝺	kqlk
庠	uugu
侂	euqa
狴	rrrh
樾	fdgx
镕	tptl
穰	rosr
螯	hwek
肄	rqxa
菈	said
罴	mhvu
隨	csfp
岙	ejso
珰	gmxl
娈	pcni
叻	lxkv
訢	ueja
鸮	lsya
邴	fktc
擊	gxqt
傷	eqjt
艏	qutk
喈	lrre
類	psdm
蓠	spxv
蕤	sdwg
條	enef
掾	abds
渑	ilkd
祆	hfgd
豉	flub
搧	aixx
茛	svnj
姰	cwjr
潾	ipra
錯	wsjr
眇	mmqp
轺	hblv
讬	oqai
纮	vsvv
鲶	qtoy
蔌	sfle
椹	fdxi
鐵	wdgg
僜	ebfu
沴	itto
侑	eswy
郴	ffcj
箧	qggu
語	ufcl
嗐	lodl
朮	fodv
矸	dhgh
璺	rkfo
幫	hham
黻	kumo
鳥	roo
歡	slle
跩	nkqp
鳟	quga
浠	iwsm
泚	inri
藿	sdwi
痱	plib
殳	qhh
憷	yffn
葚	sdxi
纡	vfau
翮	flkx
錢	wggg
喦	lllj
戋	fggi
黧	rwqn
絕	bbcb
曷	jwtx
題	jfnm
藍	ssqm
哚	lqfv
坻	htao
乂	wll
蜊	krmd
袆	pavi
瓘	gslw
捌	alxm
椴	fefq
溘	ihvm
阇	phjr
龋	ntxk
愍	caey
篁	qegn
樂	evvf
蠲	utmk
郞	ovcj
畠	ejtb
撄	akkc
嬛	cmfr
錾	hewj
洺	irlv
剀	jbmd
瞽	ddbm
陸	chth
裰	pbbb
偬	ewty
窨	pijr
唸	ltoy
蓊	stvx
峁	jtms
鏊	hwew
屄	bpxh
瘢	pqqh
茼	skfl
旄	oqrm
汊	ibod
茝	sscj
芰	sdbu
涑	iflv
摭	ausu
钡	tkbj
垆	hmbh
俣	elfg
碓	dwih
數	ldle
孓	vodl
龁	ntxv
暍	jjwx
異	jsti
嫚	cjmb
铗	tgue
亂	ebkx
绐	vvlv
埚	hlkt
媗	coff
梼	fdac
螫	httk
欹	gale
榊	fhke
壅	ovqh
赀	nrkb
紒	btti
傒	eevg
嚇	lhtt
冴	shyi
潆	isyb
逯	xkpd
熱	hthu
痤	ptth
蔸	setq
親	ifmx
翥	hjxx
毬	rfko
菽	skmb
戲	mflg
黥	noma
茭	sotw
酰	gwqr
珽	gexn
淰	itoy
禵	hjfm
柟	fkht
園	nhlr
滅	idfu
溿	ijua
復	rqje
欷	wsme
蹓	ntjt
糌	pemj
亶	onlf
蛩	fqok
枥	fsxk
決	ibte
娰	cext
蘼	spli
搖	awwo
蕈	sdjd
襦	pdsr
膈	wfln
芏	shtj
艉	qbrm
厣	sskj
傧	eoet
酚	gtbd
塍	wugh
叇	svxp
厶	vvv
菰	svqu
疸	pjfi
镪	tvlk
禤	hmxx
幪	msyd
篌	qebq
砲	dwck
謦	hbqu
醯	govm
徼	reoe
裣	ptfi
豽	ykte
蓖	srwr
酯	grjr
較	gotw
勢	hthx
繼	bvvx
孥	cbvk
斷	vvfe
糁	pvgt
卺	vkfv
鍪	cqew
蘧	smdp
祩	hwti
丌	ajj
鞫	gwua
簟	qdjd
昳	jqgu
窫	pdbg
坩	hssi
寶	ogwm
棽	fftv
隱	cefy
旉	fogu
嬖	bloc
鄄	dhcj
砻	dqdh
劻	ggxk
衹	ptai
單	lljd
熜	urey
廋	urnb
祼	hjfv
薙	sqwi
厓	shht
筚	qrrd
爾	ftmw
墼	gxqh
幹	djth
萑	swij
缍	vwsf
蚧	ktti
柰	fhsv
戆	ijey
姽	cysv
鲂	qogy
黃	sskt
湣	icaj
禔	hjfn
爔	uurs
煇	uygc
試	ugfo
態	vwry
務	cqex
儇	emfr
靚	hwmx
卮	efvi
绀	vssi
筲	qmwy
倮	ejfv
崁	jhei
媵	wugc
菸	sots
弐	fgsi
谵	oysu
澣	idjh
岜	jcbs
創	toxm
陽	cjft
礅	dove
墡	huul
缶	woo
煙	udht
甪	qtnp
鹚	uvvy
亍	ahh
矟	cqmw
刖	wmdy
鹡	ssty
澂	ijfe
卬	txjm
焗	ubvl
荽	secn
瞋	mdmt
砬	didh
鼍	lljk
瘿	pkkc
閒	kwyn
況	ilqr
擁	aovw
貓	ysjt
驺	xyxl
髀	mwdi
缫	vvjf
禦	rqfh
羏	utog
銎	fqow
羖	uqhg
襌	plld
鏦	wrtn
唎	lrmd
爲	ewwk
铘	thcj
殂	frmi
鞮	gjfn
眀	mwyf
檗	blof
悛	yvte
彟	xasb
锍	tovq
淒	idxc
嵊	jrur
饧	rvto
鲩	qofh
書	xhjr
鸰	toby
谳	odks
苷	sssi
觚	ytqu
佺	etgn
嫈	uuyc
鹕	dwya
羝	utao
觜	nryt
譞	umfr
溫	intm
満	iskj
蘖	syof
爭	exvi
號	lsmu
狝	ryma
椐	fbdg
瑷	geyb
領	tobm
誗	urmd
怱	wtoy
桡	faqh
匏	gfsc
耨	dtsa
煖	uehb
鋹	whaj
豳	jdds
舨	qebu
蝾	ksyf
猓	rjfv
搴	ostt
坜	hsxk
荸	sdyv
釐	hesk
磙	dotr
轭	hsvi
摀	aywo
珃	gkht
詝	uoan
皲	yhvp
魚	tyy
滹	imqa
犼	rvxi
蕗	snel
麈	iogn
邗	hcjg
網	bkuu
誄	udti
鲋	qeac
寔	ojfn
疝	pjsb
硼	dwwy
獍	rijq
勰	xxxy
浤	iosv
鹾	mnwf
掛	ahhm
痋	pkcb
扃	iklv
葸	sjyi
燝	ujom
旰	jhgr
溏	iuxl
偾	edsk
揎	aoff
锗	thjr
剞	galm
秾	ryry
晳	fejr
華	sfsd
寘	odmt
悝	ykki
漭	isss
嘏	dbsb
袢	puao
礻	hsss
願	semm
昝	emjr
樛	fxxt
咹	locn
釋	qpmd
薩	sciw
璔	gujj
綝	bffv
桷	fytn
黙	ksuo
舻	qmbh
彖	bdsm
裉	pvny
袛	ptao
脘	wofh
疠	pfwy
艋	qvmn
綎	bexn
嬲	jxcx
獨	rmwk
歷	srrn
參	vvvt
蠱	kkkm
陰	ctov
紓	bcus
栌	fmbh
宄	oyfb
砩	dvti
瘊	pebq
蠓	ksyd
愔	yijr
铊	tori
筥	qllv
锂	tkkj
剋	dqmd
飯	yebu
濞	itja
醫	gqqg
曈	jikk
鲎	iyqy
悃	ynfv
唣	leai
祕	hyqp
裒	orry
咥	lhkv
磾	dlld
訞	ueoa
淯	iovw
锝	tjfa
伕	egue
奭	gdjj
邡	ocjg
螨	ksft
蟲	kkkc
怍	yqmo
鄣	ijcj
爌	uust
遊	oqvp
嚐	lnrj
拶	avrk
歔	mkei
敵	ouke
觯	ytud
卐	xfnf
卍	vnfn
託	uqai
涬	ihud
鹣	uxny
绹	vwwo
湜	ijfn
颡	bbbk
袴	pgfs
肏	rktt
勝	wugx
顧	iwdm
齮	mgal
皞	eegd
換	aykg
慊	yuxt
棗	fkfk
搛	auxt
冇	skfo
彈	vlld
貴	lkmb
夾	gtte
雮	drmy
順	qdmb
冏	ktlv
幷	qhqh
陳	cfjr
塚	hydo
簏	qilk
胼	wusj
術	rfoa
皝	egmh
脩	enew
蝓	ktfm
瘳	pxxt
佔	emlv
壓	sjwh
舁	rsjj
尢	dooo
诜	owqr
芗	svqp
墬	cbdh
瑨	gauj
選	ccsp
尙	nsss
瞾	mmpf
蒌	spcn
愬	uxwy
犨	wwwn
浈	imkb
癡	prqn
唦	limq
颞	abbk
楙	fcqf
衝	rwka
栲	fhsk
鑛	wust
猲	rjwx
袼	pelv
俶	ekmb
磻	dqpj
呡	lcai
蒉	slkk
邠	tbcj
檠	swlf
佧	ekmo
哢	lgsj
鲊	qqmo
伷	ekoe
狨	rgso
觫	ytfl
栘	frrk
誴	uohs
骔	xohs
溷	inds
苊	ssvi
獚	rskt
騔	djwx
囉	lmbw
癜	pbsq
骖	xvgt
舉	rska
榇	fifv
浼	iylq
堠	hebq
隹	wii
僦	eomd
哿	xlal
睺	mebq
瑠	gtjt
硷	dtfi
釭	wfoj
盤	qqmn
馓	rswe
沢	ibod
戀	ubby
熦	umwi
隳	csfo
奮	gwjt
僴	ekjr
凊	shwy
篼	qetq
鐇	wqpj
偙	eoum
區	glll
辊	hjrr
揲	ahfv
彳	rcc
呑	elvo
垕	eflh
觌	dvsk
垴	hpxg
绱	vnss
诎	oxxg
艹	sjj
昺	jfkt
蟗	dlyk
菘	sftv
圯	hckt
蠼	kmmb
祓	hsbo
啫	lhjr
弒	wfof
锩	tugv
養	ugov
赑	kkkb
倧	eohs
糺	bxis
蚶	kssi
佷	evne
戥	jwgg
談	uuuo
藁	sofv
呙	lkte
鳳	qfro
靘	hwyc
絷	ayob
檛	fnpd
镡	tdjd
崐	jjrr
丅	akkk
佴	eare
昃	jste
釆	qpmp
瞢	smym
遹	cqkp
耪	dtoo
堅	sbht
節	qxvx
弻	vfnv
搥	aypd
騎	dgal
淏	ijfg
雜	ottw
橼	fvbd
狃	rbcq
伋	evod
萩	sruo
須	tdmb
蛶	keac
爨	rkfu
驩	dslw
雩	dfsk
輪	gtfn
頓	axdm
蕞	sjab
盪	ijfm
殭	frff
皊	etob
顫	onlm
脬	wevk
鍼	wdfl
羼	buuu
叡	myfb
漶	illy
奼	cqai
荛	saqh
嚴	llse
埳	hyrj
狔	rbri
鑽	wwqm
廣	uskt
懼	ymmw
焌	uvte
甍	smya
蒽	sngy
铓	tsuw
魽	tssi
鵰	whlr
嗾	loqq
鬯	wxri
濃	ikss
氽	tkve
錱	wggn
岵	jdgs
責	hmbf
垍	htkt
價	edmb
説	uulq
媺	cjfe
钣	tebu
逭	obbp
麍	iovq
觖	ytbt
栱	fsti
崑	jjrr
莰	shei
徹	rove
徳	rdmy
漢	isfg
茍	swlv
刳	gfsm
預	cdmb
嗻	lusu
蝤	kugo
堃	ooht
豇	fluf
秕	rrri
玹	govo
匦	ghyf
葑	shha
蒼	stol
嫽	cgum
槍	ftol
資	semb
顏	pstm
亻	eee
吣	lyiv
贇	pfgm
蠪	iwmk
婑	crcn
緾	bskk
埴	hdmi
紜	bsvv
钪	toqj
倐	eneu
窬	ptfm
劃	xhjm
緩	behb
甙	gssi
崞	jovk
眚	wmfg
歐	glle
彊	vfjf
觔	ytxk
昽	jdqp
颃	oqdk
邧	fhcj
貏	ywdi
镆	tsjg
瑧	ggrh
闶	poqj
嫜	cijd
瑢	gptl
騄	dxkv
茺	sovq
撫	aqsu
厊	shyh
郕	dvcj
骍	xoxm
礡	dsfa
嗙	louo
紞	byqr
囝	nvkw
巉	jylo
標	fdhs
敉	pehm
階	crre
褲	pugc
呿	lhvv
轵	hlti
黹	kumt
幣	umtm
枹	fwck
鎗	wtol
畛	jtto
簦	qbfu
跦	nwti
揚	ajft
啍	lovk
荘	suhf
貐	ytfm
瞀	cqem
燈	ubfu
砉	ddhn
龀	ntxr
镚	tjww
扌	aoo
鞔	gylq
芄	syod
觸	ytmk
溆	itfb
甡	wwgg
猃	rtfi
仳	erri
锘	tssl
枱	fvlv
潴	irhj
髙	onsl
硪	dqag
髑	mmwk
啯	lngo
髂	moel
钭	tsdi
弢	vxbu
碖	dtfn
猰	rdbg
屺	jbjs
胗	wtto
瘘	ppcn
湊	igfg
垱	hmxl
肶	wrri
邨	axcj
郐	tsvc
賽	ostm
伾	edfi
劵	ugxk
沬	ihes
專	gacc
翃	svxx
衖	rsta
翙	jrxx
甯	oytn
镙	tjbs
龆	ntxl
腧	wtfm
崾	jdcn
羟	ubfo
鲭	qhwy
湧	ibtx
邏	mbwp
晢	aejr
悫	hyqy
舳	qkoo
氵	iss
笭	qtob
曉	jhhh
紘	bsvv
岡	kujs
忉	ybdi
竐	iqhd
锸	twrj
孒	vfil
蛱	kgue
舯	qlns
猸	rbmf
褔	pflj
邽	hhcj
罟	mdgw
岀	jjss
锳	tskg
箅	qjaj
鬥	ndd
貼	mmlv
濉	imwi
芘	srri
絜	dbbs
绋	vvti
籼	pjsm
舡	qfoo
沄	isvv
檞	fytw
鹁	dyvy
顆	jfdm
鬧	nomv
聱	hwea
厭	sjws
轟	gggc
褰	ostr
纩	vuus
鎌	wuxt
楊	fjft
矅	mxxw
栝	frev
駐	dogn
饩	rqqs
搶	atol
烆	urah
唪	lgao
掎	agal
鲳	qjjr
謂	ujwy
莨	sovn
円	kksf
滾	iotr
昰	jfni
緒	bhjr
喚	lykg
莩	sevk
規	gmxu
尨	dtoo
丨	nsss
羨	uiei
膚	mjwy
揺	aehx
昪	jvsj
醅	gilv
畑	ujto
齁	tjal
钅	tjj
靦	gmxi
瘗	pguh
潽	iukj
偑	erfe
郄	wsvc
鈺	wgod
啶	lofn
郤	ttlc
傉	esac
埭	hxkv
棄	ovsh
廌	isuo
枘	fkte
硎	dfsm
庹	usfo
癍	pgpg
庀	uriu
暲	jijd
淨	iexv
燄	yruu
熳	ujmb
袓	pmiy
冑	kksi
湓	itbm
悽	ydxc
載	dggc
赙	kfac
淿	iemv
顒	kdmb
襲	iwmr
茈	snri
浍	itsv
鮨	trjr
牽	ovyw
忞	pyiw
糵	syop
紝	bens
辌	homa
歎	sfle
顔	iqtm
絺	bwsm
笱	qwlv
姁	cwlv
阌	peyb
擇	amhd
豐	jddu
搌	absg
旡	gqrf
猶	rugo
跽	nbyi
埵	hwsf
摽	adhs
犇	wwwn
證	ubfu
堺	hjtt
墜	cudh
弇	ysje
菉	sxkv
佉	ehvv
婼	cssl
槅	ffln
蘫	sism
檒	ffrf
僰	fkft
撙	auga
擐	amfr
膽	wysu
觋	fttk
氇	rqjr
汧	ifsj
蹻	nell
測	immd
颥	dsdk
鴷	frmr
燚	uuuu
挢	aeti
緋	blis
赸	djsk
蜎	klwy
鲦	qefv
蘡	smmc
疳	pssi
沲	iqcy
凅	sndg
桄	fmhw
悰	yohs
刂	mdd
烝	vkfu
佇	eoan
揑	arfo
碕	dgal
繞	bhhh
譔	ucct
劇	mdmd
瑊	gdfl
嚭	dldl
慓	ydhs
踣	nilv
烔	ukfl
慝	gssy
髊	mufo
窭	ppcn
燰	ueye
兟	wqwq
凱	jflq
韋	cii
臁	wuut
襞	blor
瀹	iync
執	hudo
紟	btov
獯	rwne
矧	qvns
蒇	sdkb
拏	cbtu
偳	ejsr
觍	kstk
紤	bejs
苤	sdfi
扽	aaxg
遺	lkmp
唛	lheh
眛	mhef
艴	vtyc
臥	stec
榱	fofr
玗	gfau
岎	jtbd
廆	uwuu
雞	evgw
毹	tfwr
紥	axbs
澐	idsv
揾	ajmn
暠	jolr
璝	glkm
菑	svjt
昖	jtvv
綨	bdjs
玘	gbjn
窅	pmfx
紣	bydi
慣	ybdm
闆	klll
乇	qaip
鳇	qegn
怾	ylti
嫄	csem
禎	hmmb
瑎	grre
詧	wuay
鬷	flke
飖	ewqw
坰	hklv
雋	wkfi
蜣	kuxi
哌	lery
囂	lldl
鷺	nelr
韂	gysu
鐮	wuut
髠	hqja
慾	ttly
噁	lfjy
辻	dpdi
薤	sfrf
榮	uuyf
痩	pkbu
蕩	sijt
憂	dwye
搿	tytu
墮	csfh
惣	wwty
寀	oefv
蠛	ksmo
鄉	vqoc
曐	jjjw
捲	augv
瞞	msfr
誷	ukuu
僬	ewuo
頵	xqlm
峣	jaqh
劓	tjam
锓	txyb
愰	yjmh
崙	jtfn
倓	euuo
紦	bcbs
滠	iabb
蛲	kaqh
壸	hyau
暫	gejr
鋪	wfuj
洤	itgn
騰	wugd
袪	phvv
唄	lmbv
凈	sexv
咵	lgfs
鏐	wxxt
陴	cwdi
俜	eksk
蝥	cqek
汍	iyod
詟	dqua
蓂	syjt
堋	hwwy
轹	htma
擾	adwe
猇	rmuq
稆	rllv
蝟	kjwy
筆	qxao
柃	ftob
襕	ppfu
齕	mqvi
浽	iecn
黉	iyst
燿	uxxw
咈	lvti
篍	qruo
跫	fqon
娡	chyi
巿	fmvi
掙	aexv
恧	syir
職	aigj
骱	mtti
酾	gfkk
贠	vkbv
騦	djyi
餘	ytff
蒡	souo
杩	fxmv
旛	oqqj
罃	uuyw
氍	mmwr
噴	ldsm
鄠	dfsc
瓖	gosr
輸	gtfm
滲	ivvt
鰸	tgll
跘	nuao
忮	ydbu
凵	xgg
胲	woiy
芤	svxi
罞	mcqp
攧	admm
瘮	pvvt
痖	paue
伱	etma
嘢	lkcu
踰	ntfm
苾	syqp
岺	jtob
哳	laej
饔	ovqy
鲡	qfkk
諲	udht
橦	fikk
枬	fwob
砑	dhyh
峧	jotw
蚑	kdbu
嚥	lsfu
蠍	kjwe
顗	jflm
枊	ftxj
纻	vofi
狤	rhlv
齊	ouns
墚	hibf
穸	prkx
瑱	gdmt
洨	iotw
晹	jjwt
钬	tuoj
寢	oxxb
漎	irtn
饣	rss
唻	ldlv
翛	enex
針	wdij
毎	qbdi
凜	sonr
骺	mefl
镟	toqn
媩	cdwy
谞	ovnw
毵	vgtr
觏	skhk
鹨	xxty
頉	ndmb
髎	mxxt
丒	bofi
獸	lljs
俫	efpm
糈	pvnw
嶲	jwkf
峎	jvns
酲	glgn
岣	jwlv
睱	mbsb
铦	trej
帯	sfym
曌	jwpf
喨	loqj
肷	weiy
楱	fgfg
傾	erdm
苶	stma
挻	aqnx
扞	ahgo
辒	hjmn
憤	ydsm
麿	pllv
蕬	sbbs
葇	scqf
裼	pjwt
戶	ieee
黡	ssne
農	kssn
塼	hgac
蛑	kvwn
笢	qcai
煐	uskg
懲	rfgy
酎	gaco
熺	udlv
埜	ffht
酐	ghgo
毳	rrrm
鈴	wtob
額	oelm
潵	iswe
匚	gff
紕	brri
靣	dnlv
躜	nwqk
伹	emie
钘	tfsj
獎	xwas
滉	ijmh
蕡	sdsm
泺	itma
趼	nfsj
諾	ussl
烋	efuo
锊	teac
嵴	jssw
構	fskh
摛	apxv
擗	ablo
渖	ioke
犭	rqq
舺	qkjo
鎚	wypd
玱	gtvi
勔	gxki
妘	csvv
孖	vvkk
袝	peac
悶	kyin
舴	qqmo
慉	yovj
碹	doff
肭	wkte
璿	gmym
粢	sepm
螣	wugk
獻	mfls
涠	inav
晊	jhkr
锼	trnb
蟪	kgyi
咁	lssi
銳	wtlq
吲	lvns
躧	nfki
嘅	lxvq
劂	suxm
篂	qjwg
翹	hhhx
簾	quut
嶝	jbfu
骕	xxtt
锾	tehb
斬	gejc
緜	emqb
項	fdmb
嬸	coqj
脞	wtth
縡	boox
鄜	icjl
諒	uoma
鹴	dfmy
畤	jhac
瓞	qqgu
賭	mhjr
镈	tfac
碲	doum
陧	cjht
鎖	wmmb
茳	sifo
砹	dswl
螗	kuxl
铽	tgyi
輝	mhyg
燉	uove
阼	cqmo
熲	rudm
踡	nugv
牻	wdto
製	wkmr
鸸	syar
捨	atre
廑	ugsi
姤	cefl
茲	svvo
貨	ermb
堳	hbmf
嫏	coxc
丶	odd
歛	reil
碦	doel
盩	hudm
芴	swto
潄	ifle
沷	isbo
摅	amyi
迺	dpdx
塽	hgww
酴	gtff
賤	mggg
崒	jotd
扢	aqvi
苄	soak
鬿	weju
憞	yove
燘	ukpw
醵	gmds
鞗	eneg
叢	kudb
襬	pmvr
掯	anwy
誦	ubtn
舾	qdxo
晧	jwlv
鼗	qssb
腘	wngo
懶	yflm
奓	grrk
筯	qmxk
紖	bvns
艚	qsjj
皺	wxwv
浥	ilcb
缋	vlkk
榖	hffv
筅	qwqr
俛	eylq
矻	dqvi
儍	ewxe
剉	tthm
烏	yww
衪	pcyy
鍵	wxax
蔘	svvt
擠	aous
鮻	tvte
祄	htti
甕	ovqa
朊	wfhw
鹓	orvy
貎	yrqr
哜	lpti
棲	fdxc
撚	awsu
杮	ffmv
兲	gtin
蒨	sehw
钸	tsmv
倉	toxl
喪	dllg
勞	uuyx
釿	wejj
兊	tvqr
阘	pjxx
鐾	blow
暸	jgum
蠊	kuut
躔	nukh
奌	mlgd
橥	rhjf
喛	lehb
骎	xxyb
丷	uee
谿	evgl
豾	ydfi
罣	mhht
筘	qalv
盧	mjmn
埼	hgal
斲	gbje
扠	abod
凍	sfjr
飾	yqmv
惓	yugv
圏	nugb
暐	jcir
爚	uync
漥	iphh
獞	rikk
琝	gjpw
琎	gstp
浬	ikks
濟	ious
蕺	slag
馘	utgf
癋	pfjy
鞞	gwdi
亊	auxl
辶	pdd
毌	bdim
垲	hjbj
籓	qiqj
贊	wqwm
坶	hbmt
绠	vfjw
糇	pebq
瀟	isxf
飐	qwml
頸	fvfm
骦	xdfm
瘥	pufo
髟	haaa
姎	ckgd
觽	ytjk
莶	stfi
徑	rfvf
獵	rvnb
旂	oqej
扆	iory
巻	ugbj
堉	hovw
玧	gvqr
礓	dfjf
佢	egbu
暼	umtj
洩	ikqp
蹯	nqpj
滘	iytl
踼	njft
挼	aecn
廻	nlxn
欻	uuei
忄	yiii
揞	aijr
趐	dxxi
羰	ujsu
奪	gwac
罠	mcai
缷	wxjo
肀	xlll
昻	jfxj
閤	kyen
閟	kyqp
蹽	ngum
轘	gmfr
臘	wvnb
嫰	cfle
裵	olry
璛	gxtf
厾	vhvv
鸲	wlya
潤	ikgn
岽	jama
両	fkjs
桖	fqmn
陞	cqsh
昐	jtbd
藝	shtv
傺	ewhs
垞	hoqa
塙	holt
啣	lqfx
恥	ayir
飺	nrys
剠	ommd
酞	ggod
锫	tilv
倿	eicn
廙	ujst
衄	qmbc
垟	hugt
槨	fovc
禥	hdht
梶	fbrm
厔	shkh
匊	wpmy
淓	isog
蚃	vqkc
縳	bgac
珵	glgn
赆	kbos
圝	nubb
躹	wwpm
楶	self
櫆	fwsd
窀	paxg
葰	seve
炧	uqcy
螞	kdmc
鹯	only
誌	uhyi
榍	fbmw
咶	lrev
聰	arey
鹋	sjya
鑄	whva
讠	oaa
葙	sfmf
礌	ddjt
砮	cbdh
騩	dwum
欗	fsku
葢	sgom
鲃	qcby
鎯	woxc
鷹	uewr
蕹	sovw
轒	gdsm
瓚	gwqm
窆	pqpe
璆	gxxt
桊	ugfv
粿	pjfv
晩	jyjq
恝	dbyi
鲻	qvjt
濆	idsm
誡	ugsj
蜾	kjfv
倫	etfn
劒	rbod
睒	muuo
轪	hgdc
蒴	suxw
蟭	kwuo
蟜	kell
棆	ftfn
鎧	wjfu
蟟	kgum
锬	tuuo
欄	fkfu
賴	flym
樫	fsbh
篠	qenf
銙	wgfs
锿	tory
餜	yjfv
渰	iysj
璱	gggq
謹	ugsi
丬	ueee
眢	rvmf
巯	bfoq
懞	ysyd
訸	urha
牴	wtao
熇	uolo
皘	ehwy
祏	hdhs
蠻	ubbk
鷫	xtxr
厐	sdqp
懸	mmqy
钷	tglv
锪	twty
鉵	wkcj
阯	cnij
獅	ryfm
稙	rdmi
糢	psjg
憝	ovey
偓	ebhk
驵	xmim
歩	nmqp
噀	lcct
覚	iymx
缊	vjmn
勵	sskx
饳	rxxg
傘	tttd
貫	bdmb
懗	yhtt
冱	sfbm
滍	ixfk
浰	irmd
虓	ymuf
掭	afgo
鹍	jrry
糼	bxks
馉	rmgs
倅	eotd
実	ogub
掹	avmn
礙	drqn
註	uogn
衁	uqmn
鳸	iroe
飢	yqjs
羧	uvte
糧	pjfk
瘅	pujd
钽	tjfi
瑆	gjwg
瀬	iflm
蔵	sdsc
芣	sduj
讇	ukyr
鄤	jmbc
詳	uuga
庳	uwdi
齧	dbmc
聳	rtta
柊	fesi
铞	tlmv
萆	swdi
瘭	pdhs
汭	ikte
甓	bloa
腄	wwsf
鹱	yswb
醜	gwuo
瑒	gjft
繻	bdsr
縴	bovw
眽	mery
嘠	ldwg
貪	tovm
挶	abvl
捥	aorv
纍	jjjb
璮	gonf
趯	dxxw
阽	cmlv
阝	cjj
罝	mmiw
祹	hwwo
姖	cgbu
蓥	sywj
渄	ilis
帱	mdac
爇	shtu
蕅	siky
刬	fgmd
憟	ydpm
噏	lyxx
歺	mrko
嶒	jujj
锖	thwy
鲒	qhlv
棨	iefv
浐	iiqp
劙	bdkm
矦	ysqi
膩	wgsm
祔	heac
垤	hhkt
櫃	fglm
癲	pdmm
寯	owkf
汙	ifau
洑	iesq
悺	yobb
尅	dqac
鎙	wuxw
扥	aqai
峯	jedn
衎	rhah
蝻	kdkd
蚇	kbod
晅	jfjf
勸	sllx
峇	jyes
箨	qaba
訏	ufau
嬰	mmcn
罍	jjjw
逬	qhqp
胩	wkmo
訶	ualv
朅	hvjx
騊	dwwo
钔	tpnj
蓰	srnn
晣	jaej
廍	uilc
妶	covo
絪	bngd
痺	pwdi
偲	ejyi
垯	hgpd
臢	wwqm
鹖	jwty
苧	soan
禘	houm
瞝	mpxv
冊	ncc
曵	kqod
倞	eoma
谫	ouwb
靬	ghge
瑩	uuyo
衒	rova
羮	uufg
犮	sbod
濺	imgg
卨	mnao
纟	vss
碃	dhwy
暪	jsfr
穫	rswb
嗢	ljmn
椠	hefv
溚	isye
夂	ehh
耖	dtmq
鳼	prow
潅	iqfw
唊	lgtt
雸	dssi
誧	ufua
峠	jkak
齡	mtob
諡	utsm
嚜	lnht
簃	qrrr
凥	bqjh
絃	bovo
挓	aoqa
褧	auor
葎	srxa
嘍	lldc
璷	gfoe
廒	uhwe
脽	wwiy
訪	uoga
亸	ovud
襜	pysu
嫕	cgqy
廇	utjt
宀	obb
刧	hvbd
朘	wvte
豎	sbfu
洐	irah
藫	sidj
閰	krjn
褕	ptfm
蓳	sgsi
榀	flll
氙	qjsq
軒	ghgc
攵	ehhh
齒	mcc
鹙	ruya
吜	lbcv
聍	aoan
醣	guxl
娒	cqbm
癢	pugv
啲	lewo
惔	yuuo
侘	eoqa
亹	orkm
衤	pyy
涁	ifto
鬘	hjmb
霊	dskg
鴞	lsro
屻	jbod
駼	dtff
耞	dtxl
渏	igal
赪	httk
氪	qdqr
珜	gugn
餬	ydwy
泶	iykv
盷	mwsi
噽	dldf
証	ufni
裀	pngd
斝	llyd
寛	osmx
牿	wwlv
埏	hqnx
籙	qwxk
癩	pflm
踆	nvte
篚	qgli
褍	pjsr
袥	pdhy
暱	jgsl
螦	khbs
蛁	kblv
骙	xbfg
鯹	tjwg
珦	grnn
嚒	lpvo
遆	ouyp
渋	inss
溍	iauj
窊	pqux
貞	mmbo
皽	onlv
猹	rfjf
撘	aqye
磡	ddxx
辯	ouox
燙	ijfu
丿	qpp
擓	agiw
減	idfl
彆	umtv
憍	yell
舣	qowl
燋	uwuo
锎	tpfs
攝	aaaa
焠	uotd
玚	gvto
褆	pjfn
頗	vdmb
蹡	nxwa
哴	lovn
珓	gotw
茻	xxxx
癎	pkjr
卆	ydif
皕	djdj
仫	eqvv
顓	jsdm
礤	dswh
荊	sfsm
蹐	nssw
鼌	jflk
偊	eqlk
鼷	rbeg
崈	ohjs
筊	qotw
揝	aemj
樋	fbtp
蹅	nfjf
痄	pqmo
悾	ypfo
枒	fhyv
巈	jgwp
峊	yjsd
覤	mmxu
倶	emft
裈	pyhc
祿	hbkv
栻	fgfo
溼	ifvh
蓆	susm
妸	calv
鑨	wiwm
漈	iwhs
搵	antm
濪	ihwc
巔	jdmm
抃	aoak
姞	chlv
敚	ulqe
艷	jddc
趎	dwti
毘	jrri
扙	asod
颭	rmlv
競	ilqq
榼	fhvm
鞃	gvvv
纁	bwne
鏮	wuxk
偡	edxi
焮	ueei
砫	dogn
矝	cqtb
礟	ddww
杙	fgyv
唡	lfkt
頑	fhdm
訂	uana
菓	sjfv
螬	ksjj
馃	rjfv
咇	lyqp
頠	ysvm
顠	dhdm
掻	abkc
疍	vnjf
朏	wxxg
鐲	wmwk
怳	ylqr
愑	ybtx
繤	smgb
瞵	mpra
犺	roqj
蒳	sbkt
麹	hewp
镦	tove
艸	xxgg
拠	aeqj
鸊	blor
洚	ieao
铑	thri
爊	uiuo
钇	tvij
蝀	kfjr
尪	dgno
蓕	sfhh
鈔	wmqp
菻	sffv
麀	iril
濊	indm
撢	adjd
綻	bofn
頻	nmdm
藚	shmm
鬽	wtou
耩	dtsh
匄	wuwy
洸	imhw
葜	sdbg
硁	dbfo
頰	gttm
愝	ygjc
迍	axpd
斅	rwwb
瀍	iukh
眞	rmxt
懮	ydwe
磌	ddmt
膄	wrnb
帨	mulq
镮	tmfr
嵙	jrsd
櫈	fbfq
塗	itfh
儼	elle
撖	avae
鷉	emro
聼	vady
羵	udsm
畯	jvte
囷	nrhw
澭	iovw
鸺	efya
澀	ibon
蹱	nikk
挷	adcj
贳	hkbi
荳	sflu
瞜	mldc
偵	emmb
鞥	gysj
蔔	swfj
廴	xnn
杇	ffsk
竢	ivqi
匯	giwi
熌	ukte
楗	fxax
唗	ldkv
魟	tfoy
镎	tytu
奷	cwkn
芧	scuj
汎	iqod
筭	qgsj
璾	gous
鉷	wsti
捊	aevk
媧	cnan
圧	shth
娖	cnvn
雛	wxww
璪	gllf
凖	swdi
媜	cmmb
矞	cqkl
歘	uuue
鈇	wguj
钐	ttoj
驕	dell
瘖	pijr
砢	dalv
吿	wlvn
胠	whvv
囓	ldbm
朣	wikk
腸	wjft
禝	hjte
竊	pqpv
嚿	lswr
曪	jmbw
甃	ruaw
晼	jorv
醭	gkug
謙	uuxt
僎	ecct
曚	jsyd
翾	mflx
偽	eoww
誐	uqag
阨	csvi
轎	gell
鱽	qbdy
挐	cltu
禖	hssf
芵	sbte
辀	hqoc
醰	gdjd
萳	sdkd
畬	tffj
囍	dldl
蟸	dkkc
貝	mbb
袞	otlr
閣	kelv
镋	tnqr
壄	fcqh
漼	ijwi
橝	fdjd
涴	iorv
盦	tovm
灜	iumb
濄	inpd
儛	eqsa
倻	eacj
鹎	wdya
碨	djgf
耑	jsrs
眮	mkfl
菼	suuo
麕	inrh
鄘	uxwc
敧	galb
狜	rdgq
窾	phhe
槻	fgmx
擡	ahlh
泆	iqgu
劐	swbm
镴	tvnb
嶋	jros
矌	must
裯	pwhl
膣	wphk
濩	iswb
昞	jfkt
雝	vlcw
込	rpdu
宆	ovgb
栒	fwjr
蛦	kgvg
舖	trfu
泂	iklv
掞	auuo
癨	pdwi
筳	qexn
顛	dmtm
鹔	xtty
哋	lhcy
滯	isfm
蔹	stfe
囯	ngnw
摎	axxt
戦	ijdg
搯	aerj
镃	tuvv
絔	bdjr
瀼	iosr
擱	akel
揙	ainc
棟	ffjr
腽	wjmn
鹢	utmy
泙	ihue
眘	gumf
髈	mouo
憯	ygqj
噷	lije
婞	chud
喤	legn
勅	flxk
餗	yflv
銅	wkfl
鞶	qqge
饀	yerj
澴	imfr
邉	tplp
抷	adfi
績	bhmb
怮	yvxk
靇	diwm
軏	ghwc
鄴	kutc
銷	wmwy
鐚	wfjy
隠	cexy
吚	lxqp
脥	wgtt
瞍	mrnb
尓	qmak
経	bbht
攽	tbeh
朒	wktt
鸴	iyya
譚	udjd
誔	uexn
噇	likk
駡	lldm
浿	imbs
葔	sebq
訣	ubte
陜	cgtt
脎	wwfv
摰	htht
餂	yres
橿	ffjf
魋	wwiu
躭	wyqr
杄	fwkv
釦	wlvj
踧	nkmb
漷	iovc
啞	lfja
羃	msjm
鄭	uggc
灘	isfw
鰣	tjha
裩	pjrr
睖	mhte
朓	wqss
厖	sdto
斃	umtr
嗛	luxt
侫	eucn
馎	rfac
刄	bodd
饦	rqai
煵	udkd
宧	oscb
鐏	wuga
麥	dehl
舭	qrri
飊	uuur
噐	llfl
丗	sfis
抜	asbu
蒻	svss
謊	usuq
撴	aove
鈚	wrri
淂	ijfa
钆	txij
盻	mtsk
遯	wdpd
偁	eekh
瘕	pbsb
靨	sjwg
稂	rovn
稌	rtff
豈	jflu
玆	ovov
艱	sflv
瀞	ihwv
嬿	csfu
晸	jfne
楛	fsdg
縢	wugb
糞	pjst
癱	psfw
舑	rkht
耵	aanr
扺	atai
咉	lkgd
嗶	ljsa
僇	exxt
掫	aabu
潝	iyxx
膪	woul
娭	cvqi
屭	bmmm
皏	eusj
棬	fugv
渟	ioan
镅	tbmf
殽	wswq
雚	sllw
鬹	gmfn
薆	seye
廞	uwei
侼	edyv
靪	gane
徴	rgni
壽	hvfa
隢	chhh
奡	dmgt
禿	rqrh
胐	wxxg
暎	jskg
剬	jsmd
緼	bjmn
沘	irri
樉	fgww
螢	uuyk
効	otwx
滃	itvx
巒	ubbj
驟	dabs
迶	swpd
筦	qofh
蔀	silc
頀	ijsb
黦	norv
虇	svsw
癃	pcew
鮀	tori
昫	jwlv
逷	jwtp
慒	ysjj
摗	afle
缏	vefw
憊	esqy
巜	vccc
袑	pblv
咾	lhri
篴	qdpd
嗆	ltol
酺	gfuo
躘	niwm
暤	jegd
疪	prri
砵	dffi
鮗	tesi
珌	gyqp
洢	iexq
騒	dbkc
擭	aswb
栆	dlts
瑑	gbds
碻	dolh
囮	neri
疰	pogn
蠙	kofm
虀	souf
煴	ujmn
軿	gusj
魘	sjww
祅	heos
吳	lxgd
贌	mkug
醑	gvnw
柸	fdfi
遫	flep
铚	thkj
邅	onlp
呴	lwlv
坉	haxg
侁	ewqr
鸧	tvya
柷	flqr
宭	oxql
鬴	flkf
毣	xxrm
昩	jhor
倷	eghs
敊	kmmb
嘨	lxpt
鬒	hdmt
瑤	gwwo
咷	lqss
唌	lqnx
搢	aauj
褵	ppxv
剷	iqwm
湳	idkd
磝	dhwe
槤	fgpd
嚧	lmjm
筸	qjhg
倕	ewsf
嘩	lsfd
臞	wmmw
靑	hkks
抯	amio
恗	ygfs
涶	iwsf
繐	bgyi
鰡	ttjt
嫵	cqsu
鏢	wdhs
皀	erib
蜋	kovn
鬺	flkt
憵	bloy
鹵	kll
璹	ghva
耢	dtsx
竜	ikdd
鏰	wjww
鑯	wttf
変	pehi
杬	ffhw
耰	dtde
兛	dqwk
剝	bkmd
扜	afau
鈡	wlns
喯	lgds
鎔	wptl
遜	vqbp
豝	dcbs
葊	sysj
儵	enen
踘	nwpm
漤	iffc
韮	slfi
瓫	tbaw
硚	deti
鞎	gvne
蠟	kvnb
趙	dmwy
寃	oylo
暕	jfnu
檓	frfq
啓	ielv
瓃	gjjj
棌	fefv
藟	sjjj
脤	wsny
慽	ydkm
呉	lxft
晛	jmxr
畷	jbbb
眫	muao
渧	ioum
鴳	ocro
緞	befq
揌	ajyi
愖	ydxi
襛	pkss
勻	wsiy
箙	qwxb
觱	dflt
欵	rqei
睮	mtfm
曽	ujjr
汸	iogs
鴸	wtro
宊	osqb
旿	jqdi
坵	hefi
莾	sgds
妧	cfhw
犖	uuyw
睄	mmwy
乢	jxis
礑	dnjt
矈	mepo
绖	vhks
擩	adsr
羶	uonf
鬵	gqgn
籟	qflm
豤	dvns
簠	qfmn
藠	seee
簮	qggj
駁	dwwl
籥	qync
挰	algn
觝	ytto
岕	jtti
蔴	spaj
儈	etfj
鲙	qtsv
狢	relv
鰉	tegn
霙	dskg
栢	fdjr
筩	qbtn
滛	iewo
錞	wovk
臍	wous
蓣	scdk
頷	tovm
涭	ieyb
鉄	wqgu
劄	qymd
鰲	hwet
蹺	nhhh
麑	irqr
験	dyte
搆	askh
焄	xqlu
玼	gnri
鰏	tflj
謠	uwwo
栴	fqwo
髃	mkyg
殢	frsm
碥	dinc
碩	ddmb
蜺	krqr
耥	dtns
莙	sxql
唝	lfkb
惙	ybbb
癕	povw
蝂	kteb
嶺	jtom
苽	squj
斂	rehl
憇	rssy
鄰	prac
棐	lfvi
嗮	ljdx
骻	mgfs
豊	ksfu
咑	laan
榢	fods
稟	onlr
皁	edib
屝	blih
菝	saso
喓	ldcn
巵	efcb
渼	iugd
濙	iuuu
鈌	wbte
怊	yblv
袗	ptto
黴	rfne
笹	qhik
磞	djww
凃	stff
踖	nsjr
崄	jtfi
鞰	gjmn
泹	ijfi
旳	jwod
悢	yovn
饋	ylkm
豗	hdsw
吪	leri
麯	deks
纋	bdwe
氺	kvvv
賨	ohmb
誙	ufvf
鄚	sjgc
濁	imwk
镄	tvtk
鉤	wwlv
捁	awlv
敘	tffe
儯	eugd
澥	iytw
鞆	gfkt
礜	rskd
獃	jfls
熾	uigj
譟	ullf
扐	axko
舲	qtob
鸁	urow
仂	exke
肈	igxa
庼	urdk
嗗	lmgv
蚿	kovo
攢	awqm
洊	isnv
酏	gcyo
窋	pxxg
诐	ovpa
盝	xkmn
踨	nttn
淪	itfn
楢	fugo
詑	uori
暋	caej
硿	dpfo
澒	ifdm
栣	feen
瑳	gufo
匤	ggod
慆	yerj
缐	vekv
飆	sssr
癀	pskt
産	iqwg
崿	jlls
搫	qqtu
劖	ylrm
袵	peen
拺	afkf
铏	tfsm
頔	kdmb
喣	lwlu
苳	sesi
鰗	tdwy
蟁	cakk
鲌	qeby
飔	qwjy
霅	duay
侓	exao
尃	facu
徧	rinc
蠧	hydk
缲	vllf
頌	tvdm
牣	wbod
箠	qwsf
脲	wbkv
唅	ltol
掤	awwy
堌	hndg
鲐	qvlv
贈	mujj
焅	uwlv
飗	qwtj
瓛	gmfs
憚	ylld
渻	imqm
嬻	chmm
訕	ujsa
拑	assi
鞷	flkg
郱	uscj
鰧	wugt
晈	jotw
挕	aaro
貧	tbmb
灕	ipxw
儸	embw
寑	oexb
鑾	ubbw
頒	tbdm
鵹	rwqr
癮	pcey
皦	eeoe
亖	ssii
勍	omxk
嚚	llsl
啅	lmjd
恘	yefv
娀	cgso
樁	fgrj
傜	eewo
輗	grqr
羈	mgdm
済	ipts
牋	tggg
憗	deyi
赨	httk
熛	udhs
妬	cdhn
宬	odvi
臒	wswb
痾	pcal
楩	fefw
戤	vbmg
袿	phht
婗	crqr
惛	ytaj
慇	exvy
嶬	juqg
蜼	kwic
陿	cggt
稧	rdbg
鱓	tlld
挜	aaue
鸑	rusr
禋	hdht
戸	ieee
綴	bbbb
嚗	ljsk
铇	twck
偪	eflj
翯	xxol
枙	fsvi
柮	fxxg
齆	tjac
礎	dffn
氈	onlr
巂	jwkl
簉	qwlp
肐	wqvi
鳀	qjfn
墊	hudh
脧	wvte
嬬	cdsr
棪	fuuo
讙	uslw
媟	chfv
涏	iexn
醄	gwwo
漿	xwak
懽	yslw
吥	lduv
冂	kff
褯	pusm
濫	isqm
慥	ywlp
兪	rfwv
鎲	wnqr
穉	rbkw
煕	scuo
煶	ujfn
彥	psto
逌	mnbp
摥	aqjt
墦	hqpj
睍	mmxf
凘	sdej
矰	qujj
蠋	kmwk
睸	mbmf
壂	bsth
痀	pwlv
鈎	wwvv
邭	wlcj
澆	ihhh
釁	rkfb
蹠	nusu
秗	reoh
榦	djtf
竅	peoe
鳘	qbeq
陏	cswy
廕	uctv
粧	puht
酂	wqwc
漧	idjv
骹	motw
魖	wmkg
膆	whbs
雰	dtbd
荖	shri
穂	rfky
硰	imqd
眝	moan
缞	vofr
礞	dsyd
瞫	mdjd
緲	bmmq
鐄	wskt
煹	uskh
磈	dwuh
欬	oeii
沍	ifbm
贗	serm
絙	bfjf
獏	rsjg
勷	osrx
唚	lxyb
闍	khjr
嫃	cdmt
璫	gnjt
醁	gxkv
稊	ruvq
碔	dfgn
驀	sjgd
磉	dbbf
酙	gsdi
茇	ssbo
冦	yfhb
銘	wrlv
祘	hhss
橕	fnhy
犂	rwqw
碞	llld
腫	wwkk
鐻	wmds
曮	jlle
麄	tbil
罥	mlwy
誱	ufxn
迒	oqpd
粋	pydi
炟	ujfi
髥	hksi
虩	mjmm
滶	ihwe
挌	aelv
磳	dujj
轓	gqpj
繄	gqqb
袐	pyqp
玽	gwlv
煆	ubsb
軃	wlld
綉	brvj
侽	ejxk
姵	cqfm
恇	yggn
疢	puob
録	wxkv
飋	rggq
嗏	lstf
屇	bjth
発	bsqr
滳	ioul
毦	armr
覩	hjmx
巇	jmfg
憀	yxxt
慬	ygsi
脰	wflu
増	hujj
锧	tedk
臲	tfyv
碏	dsjr
醨	gpxv
幋	qqmv
兓	gqgq
窎	pyax
嵁	jdxi
壖	hdsr
嫞	cuxw
憙	dlyi
擿	aoup
菿	shmd
姱	cgfs
琱	gwhl
誸	uvov
噉	lvae
漻	ixxt
欉	fkub
蹧	nsjj
欶	flei
喴	ldfc
颼	rrnb
姫	cscn
訳	ubod
鯛	twhl
鋋	wqnx
唶	lsjr
秏	rrmh
焇	umwy
瑮	gdfv
愽	yfac
耔	dtvk
烓	uhht
毷	ksmr
睲	mjwg
溁	isyf
滈	iols
擵	aptu
薿	srqn
曆	srrj
菥	sfej
骃	xngd
鵚	rqro
篨	qctf
訑	ucya
猨	rehb
刪	nmdc
佽	esei
騃	dvqi
闬	phgn
蘘	sosr
帩	mmwy
緤	bhfv
哱	ldyv
歯	npxg
厠	smmd
齷	mbhk
褾	pdhs
葅	sttm
鉏	wmij
閦	kttt
呠	lffi
熣	ujwi
衕	rkfa
筴	qgtt
鞧	gugo
澽	imds
轍	gove
詨	uotw
蔾	srwf
帢	myev
绤	vttl
糥	pssr
哖	lqao
鷬	sktr
珫	govq
癴	pubt
駹	ddto
椀	forv
焟	usjr
縈	uuyb
廾	sjjj
堷	hijr
哃	lkfl
趫	dell
蟳	kxfa
牮	egwn
徶	rume
魀	wtti
覼	ftmm
镨	tukj
嶓	jqpj
蒒	syfm
狑	rtob
蕭	sxtf
淛	iwkm
蹍	nbsg
飸	lsys
覙	ymmx
兎	qlqo
繆	bxxt
秅	rqai
郈	eflc
儭	eifm
袠	oqgr
淊	iyrj
様	fukv
睆	mofh
揵	axax
塹	geht
銊	wdfi
褅	poum
牚	nhys
峵	josv
夋	vteh
涰	ibbb
迵	kflp
尫	hgnw
吰	lsvv
蓏	sqqu
蝲	kflm
烕	dfuo
冓	skht
瓌	gomr
鄫	ujuc
矋	mssk
璉	ggpd
澨	iqft
髴	hvti
貒	yjsr
譪	usjx
矊	mbem
剚	alxm
諕	umua
斁	mhue
踚	ntfn
鹮	mfly
兯	uxje
臓	wsds
杦	fyod
攅	aggm
帲	mqhh
楏	fghh
歠	bbbe
螲	kphk
綯	bwwo
鍠	wegn
琩	gjjr
巗	jlle
鯾	tefw
諔	ukmb
寖	oixb
拝	afdn
嫀	cgrh
爧	udlt
鋙	wfcl
枲	vlfv
羒	utbd
婙	cyxv
浟	iene
泝	ieod
粄	pebu
踶	njfn
牐	twrj
酕	grmo
摯	hudt
飂	rxxt
気	qwlq
簰	qtwd
鉆	wmlv
貙	ygll
篋	qggt
勀	dqxk
湝	irre
卲	blxj
筞	qofv
鄗	ocjl
潏	icql
姶	cyen
檡	fmhd
臑	wdsr
蟢	kdlv
鷿	blor
锽	tegn
裇	pqmn
碝	dsgd
嬢	cotr
靰	ghwe
煼	uwxx
籬	qpxw
鯊	imqt
蕓	sdsv
錧	wobb
痠	pvte
釬	whgj
処	eqjh
俢	eeto
僄	edhs
跓	nogn
僊	edgc
勈	btxk
秖	rtai
讞	umfs
苙	sidj
衠	rdma
桲	fdyv
嘮	luux
廬	umjm
乗	rsjh
鈍	waxg
窯	puuo
抅	awvv
矔	mslw
圞	nubf
軦	glqr
泩	iwgs
洴	iusj
禂	hwhl
涷	ifjr
鲗	qkmd
阛	pmfr
糬	pmhj
瘝	pmkv
蒑	sexq
妰	cqmo
詌	ussi
菂	sewo
儾	edlr
騑	dlim
筻	qfjw
昬	cajr
鴻	ifro
囖	lqmw
瞹	meye
訧	udoa
斶	emwk
辢	flox
劑	ounm
醌	gjrr
盫	ygmn
喭	liqt
厪	sgsi
襈	pcct
鼑	mmxt
鉥	wfod
嵂	jrxa
蟦	kdsm
鲰	qabu
榾	fmgv
骴	mnri
熥	ubtp
鷃	jocr
鵩	wxbr
珹	gdvi
袮	pqma
娵	cabu
闉	kdht
敠	bbbb
豖	dods
傌	edme
枓	fsdi
巊	jmmc
嬾	cflm
蘪	sipm
褭	odry
嗱	lytu
倂	eqhh
鐧	wkjr
櫜	dlyf
蝜	kymb
眤	mbri
饾	rflu
醖	gjmn
榅	fjmn
恡	ywsv
裭	pmuy
翣	xxic
攲	galb
孋	cfki
梾	ffpm
迻	rrpd
髽	htth
橸	fjjj
曎	jmhd
哊	lswy
捒	aflv
穟	rudp
銹	wrvj
穎	rrdm
弍	gsiy
啗	lyrj
啑	lfxn
餔	yfus
呪	llqr
鳷	dbro
僥	ehhh
礧	djjj
騨	dijd
颋	exdk
遈	jfnp
熕	ufmb
撝	aeww
吙	luov
呺	llsk
璄	gijq
躩	nmmb
彫	whlt
秬	rgbu
刲	hhmd
癚	pysu
繖	bswe
镥	tqjr
覀	dxxx
噑	lesd
鏗	wsbh
暏	jhjr
疒	pbb
玃	rmmb
鷟	oqqr
鞓	glgn
軫	gtto
噭	leoe
兠	eurq
裛	olcr
髢	hcya
鼽	tjay
瓓	gkfu
荅	syej
啈	lhud
赒	kwhl
襩	phmm
駮	dotw
楉	fssl
俁	elxg
琙	gglf
蕰	sijm
蓚	sent
蠈	mgsk
俍	eovn
剕	lmdi
瑺	gnmv
琭	gxkv
冖	ymm
駉	dklv
埈	hvte
睌	mylq
駝	dori
隄	cjfn
恞	ygvg
挵	agsj
邲	yqcj
钖	tvto
宍	ooti
曖	jeye
鸂	ievr
郪	dxcc
鬅	hwwy
覊	dgdm
頞	ocdm
龒	iwmh
幒	mrey
痃	povo
熖	uerj
榑	ffac
趷	nqvi
鋿	wnsj
雔	wwii
騠	djfn
髣	hoga
彽	rtao
媢	cksm
倣	eoeh
巃	jiwm
営	iyll
旵	jjsr
仏	evve
椏	ffja
輾	gbsg
幰	mody
絯	bois
碢	dnah
薬	sesf
譁	usfd
魼	thvv
擼	atjr
墻	hhtl
傞	eufo
呟	lovo
檳	fofm
孉	cslw
桯	flgn
莂	slxm
黐	rtkv
脢	wqbm
曒	jeoe
浭	ifjw
巚	jmfs
兏	ekqr
嚔	ldyn
勊	dqxk
讃	uggm
蓺	shto
眥	nrmf
坬	hqut
鄡	rfcj
蚮	kegy
爄	ussk
鰃	tjgf
楻	fegn
橧	fujj
抝	avvi
玨	ggnn
艶	ksfc
抆	apwo
麤	iiil
簖	qpxe
瘡	ptol
迾	frmp
冿	sxao
焃	uhtt
鐩	wudp
鼕	ddbs
搰	amgo
俆	etff
阬	coqj
蒄	syfa
篜	qvku
煠	uhfv
虡	mkti
巹	vkfb
嫿	cxhf
鳆	qqje
袊	ptob
摚	anht
潚	ixtf
癶	buuu
県	mxma
嵵	jjha
藨	siuo
椯	fjsr
粫	psrm
龑	iwmg
鷄	evgr
冨	yflj
捜	akbu
珝	gxxi
兞	dqrm
騂	doxm
蚆	kcbc
駃	dbte
幵	hhgg
藴	sbjm
頬	gudm
蝪	kjft
稲	renj
曀	jhyu
粃	prri
軻	galv
敻	ykte
渉	inmq
璊	gsfr
逕	fvfp
敍	tffb
韄	gswb
蓇	smgj
塨	hsto
屛	bqhh
茖	selv
嘓	lngf
耱	dtpd
訫	uyia
愄	yjgf
瘃	pdod
澻	iudp
膫	wgum
嘷	ltsd
壼	hyfj
穄	rwhs
縺	bgpd
贅	hwem
嗃	lolv
煚	jgbu
歀	fhei
晉	fvvj
嚞	hlhl
怰	yovo
譓	ugyi
灩	ijdm
傐	eole
讻	owxg
顱	mjmm
鏽	wxtf
猋	sssq
捵	akst
狉	rdfi
広	uvvu
枌	ftbd
菫	sflh
脁	wqss
眐	mfni
斠	skhd
翝	osvx
簕	qgxk
摐	artn
岍	jfsj
絰	bhks
褀	pdjy
籄	qglm
眆	mogf
刓	fhmd
錅	rwqw
続	bhyq
撦	aghj
幙	msjg
唘	dblv
癉	plld
昡	jovo
禚	huuo
剟	bbbm
嵚	jtei
僣	eggj
忳	yaxg
縰	brnn
珖	gmhw
筜	qmxl
罇	wuga
饤	rans
偱	eedm
冡	yfds
搒	aouo
嵕	jwxe
掁	ahao
狓	rvpq
値	edmx
鄀	sslc
撃	gqtu
鮎	tmlv
諠	uoff
弎	gfay
黱	wugn
毆	gllq
聻	igea
馂	rvte
硏	dhhg
韡	csfd
槱	fguo
摃	afmb
緌	brcn
蠸	kslw
奍	ugti
醽	gdll
敁	mlmb
淴	iwty
鳈	qekv
栿	fesq
搕	ahvm
墵	hdsv
玊	godn
甁	qhqa
阢	chwj
雊	wlwi
抈	awyo
睩	mxkv
俇	ergn
兡	dqdj
鴙	qroi
覧	sqmx
蔍	silj
慤	hqyi
鷘	fler
礐	rwwd
藘	smjy
佖	eyqp
擲	augc
瞐	mmmf
緑	bxkv
犽	rhyq
狶	rwsm
蛼	kgcc
祲	hxyb
鏘	wxwa
懭	yust
矎	myke
覠	xqlm
晬	jotd
洿	igfs
鄧	bflc
晝	xhjf
遡	uxwp
浄	iyxv
抶	aqgu
攜	ajwl
鴈	sero
麃	iuol
塭	hjmn
孼	xyov
椸	foqc
遝	mkpd
璬	geoe
崌	jbdg
輦	gggc
蝭	kjfn
奤	ggid
僝	ebvv
綫	bggg
腃	wugv
叚	bsbb
褉	pdbg
伮	ecbu
獕	rjwi
謢	uwbu
鮹	tmwy
眔	mkvw
愊	yflj
槡	fbbf
壘	jjjh
珇	gmin
鮝	ugty
対	pacw
跅	neod
枻	fhiv
赗	kksm
鬖	hvvt
癈	pbvq
晻	jgkd
搊	awxx
朼	friv
寽	eack
椓	fdod
関	kugd
噯	leye
癟	pttn
垐	seht
怤	eayi
筼	qlkb
鄩	xflc
澪	idtb
畾	jjjt
矙	mkve
爠	ummw
熯	usfg
墥	hikk
餿	yrnb
炵	uesi
歭	nhac
踀	nnvv
揅	dfst
箒	qxym
猂	rjhg
顰	nmdd
觹	ytwk
殲	frtf
鴂	btro
絁	bqcy
磥	djbs
耭	dtvt
綹	beml
覥	kstm
豋	wflu
膸	wsfp
踦	ngal
悁	ylwy
邩	ucjo
歳	ndfm
瀂	itjr
吅	llvv
鞚	gpfo
醿	gpbs
僷	eshf
觺	rqbt
穠	rkss
唃	lytn
灋	iisv
嚀	loya
詥	uyea
衺	ohry
髆	mfac
矘	mnne
夐	ykte
畇	jwsi
廸	kxno
巑	jwqm
昒	jwto
覇	dgwy
殹	gqqh
咲	lugd
餽	ywus
瑬	iovo
厎	stao
玁	rlle
鏁	wvjf
乄	vodi
躄	blon
淸	ihkk
卼	hysv
瞱	msfd
毼	jwtr
瀾	ikfu
薫	swku
矴	danh
恾	ysuw
鉶	wfsm
繙	bqpj
抳	abri
祫	hyes
埇	hbtn
蹎	ndmt
櫬	fifm
漦	hesk
牸	wovk
腂	wjfv
皥	etsd
瞶	mlkm
愒	yjwx
諂	uyrj
頟	eldm
壡	myfh
槖	hydf
忬	ycui
冃	ksif
眱	mgvg
霬	djst
膲	wwuo
冺	scai
鱉	umtt
挙	ittu
翂	xxtb
弾	vijd
獝	rcql
弨	vblv
菾	sfgo
槺	fuxk
栃	fefw
巐	jojs
侲	esne
矉	mofm
瀉	ioru
烱	uktl
辧	obox
耹	atov
佪	enlv
賬	mhab
胘	wovo
礵	ddfm
鴥	rpxo
憭	ygum
摴	adfs
碐	dhte
埗	hnma
眏	mkgd
馌	rhvm
磗	dfac
屮	xggg
昄	jebu
読	uhyq
穜	rikk
襴	pkfu
躡	naaa
骫	myod
鱑	tskt
蝍	kxvx
跴	ndxv
赕	kuuo
濔	iftw
菨	sicn
馩	rjdm
蠣	kssk
篘	qwxx
襨	pkua
惻	ymmd
慭	fpsy
圂	ndsw
鰤	tyfm
苖	skoj
唩	lrcn
総	btvy
騕	ddcn
啛	ldxc
褞	pjmn
頽	rqdm
痳	psia
莋	seqm
礬	fwwd
瑍	gykg
柤	fmiv
査	fmiv
浹	igtt
撾	anpd
郙	fcju
熝	uilo
鍚	wjft
冮	sfoi
衵	pjry
煋	ujwg
濱	iofm
扅	irrk
糒	psqt
剺	hesb
鑿	kudw
鱲	tvnb
鋘	wlfg
膔	wily
啽	lysj
鋁	wllv
塿	hldc
虯	kxgc
尐	moda
鰜	tuxt
鈿	wjtj
蟷	knjt
禃	hdmi
瘉	ptfm
鏠	wedp
鄃	tfwc
脦	wgyi
胔	nrkt
働	ewkx
駥	dgso
鷲	omdr
禑	hkys
湅	ifnu
襆	pkug
呫	lmlv
瀕	inmm
檿	sjwf
収	xbug
袚	psbo
娚	cjxk
奺	cyod
辁	htgn
冎	naaa
泈	iesi
闐	kdmt
瑏	gphy
楧	fskg
璂	gdht
揜	aysj
篶	qfnu
躙	nkwi
阺	ctao
骲	mwck
捘	avte
醩	gsjj
嵉	joan
禬	htfj
鐭	wrpg
呧	ltao
盄	vnmn
覜	qssm
镤	tkug
窰	pewo
撈	auux
儽	ejjb
鞳	gsye
鷡	qsfr
傓	eixx
邤	ecjj
睠	mugv
兝	dqtb
竒	ilvi
堐	hshh
腪	wygc
譏	uvvt
僁	eqpy
怹	ecyi
晫	jmjd
璥	gswe
嚮	vqor
苺	sbmj
嵰	juxt
孅	cttf
琌	gjtv
庛	unri
硑	dusj
籣	qkfu
嚬	lnmm
酅	jwkc
謿	udjw
扝	afsk
覮	uuym
簁	qrnn
渞	iutk
嶈	jxwa
軼	gqgu
抦	afkt
獦	rsjx
壃	hfjf
餋	ugys
挒	afrm
饘	yonf
莻	svlr
鉓	wqmv
稭	rrre
犠	wuqg
鹥	gqqy
巣	ijfv
啴	lujd
灐	iuuw
籧	qmdp
磂	dtjt
伝	esvv
晲	jrqr
駿	dvte
晙	jvte
瞆	mlkk
茞	sscj
剮	nmda
楽	essf
崅	jytn
貋	yjhg
鴏	regy
襥	pekg
躑	nugc
皐	essd
肸	wtdi
榺	wugf
棓	filv
綀	bflv
灬	uooo
惷	gjyi
硍	dvnh
柫	fvti
椫	fujd
岞	jqmo
楡	frfv
讟	uhmu
逤	imqp
玈	ovqr
敭	jfwe
狌	rwgq
塩	hqlm
跙	nmiv
隩	crpg
疐	dyjn
葴	sdfl
澼	iblo
閛	khue
邔	bcjj
儅	enjt
喞	lerx
澿	iffh
弪	vbfo
屟	bhfv
驌	dxtf
咗	lsfo
韨	avso
葧	sdyx
懆	yllf
萣	sofn
愳	mmyi
紵	boan
昜	jfwt
矕	ubbm
頤	sdmb
涙	iigd
鮰	tnlv
犛	hesw
昚	gujr
闒	kjxx
遼	gujp
岠	jgbu
驎	dpra
刜	vtmd
鷔	hwer
舋	rkfm
詔	ublv
絛	eneb
凂	sylq
覽	sqmm
鷩	umtr
兙	dqdi
蜅	kfuc
盇	gomn
巌	jise
珋	gtmn
塥	hfln
蜑	qnxk
鬋	huwm
浡	idyv
眗	mwlv
鬑	huxt
駸	dxyb
唽	lfej
矖	mfki
芛	sxqp
诪	odac
枼	hfvi
掟	aofn
痡	pfub
謀	ussf
婌	ckmb
禆	hwdi
躝	nkfu
亙	fwfi
禨	hvvt
帟	pmvi
鳽	fsro
楜	fdwy
繈	bvvk
卩	xjj
撓	ahhh
颱	rvlv
呾	ljfi
愐	ygii
哻	ljhg
邇	ftmp
洟	igvg
仭	ebod
墈	hdxx
蹷	suxn
偋	ebus
抲	aalv
瑴	hfgn
娫	cqnx
凟	shmm
烸	uqbm
鈞	wwsi
竴	iuga
欃	fylo
脄	wsuo
詖	uvpa
眹	mugd
鵜	uvnr
麰	devw
庝	uesi
薾	sftw
脋	bbbw
藹	sujx
畊	jsti
伈	eyie
亠	obbb
漬	ihmb
伓	edue
懾	yaaa
硊	dysv
犲	raqp
蘐	sueb
轄	godl
氄	cqkr
牷	wtgn
僯	epra
騞	dddh
飀	rtjt
玞	ggun
槦	fuxw
鳣	qonf
僼	eksu
賖	mtff
悗	yylq
簔	qofr
庮	ugou
嵑	jjwx
榚	fuuo
氕	qqpq
甝	mssi
劏	njmd
鈅	wwyj
齎	ounm
驖	ddgg
踠	norv
跔	nwlv
跰	nusj
耎	sgdr
罛	mquw
蠤	ugkk
媻	qqcn
飡	sysi
虒	emuj
誆	uggn
頩	usdm
蘹	syor
毑	bcym
淍	iwhl
獽	rosr
漋	icew
郂	ocji
戄	ymmb
膢	wldc
潠	icct
梡	fofh
鑵	wslw
犾	rsqq
偘	elll
儦	eiuo
膧	wikk
玾	gkjn
汒	iuws
俥	egce
啀	lshh
棧	fggg
埰	hefv
苼	swgj
莯	sifv
獈	rutm
逥	mspd
礩	deem
鹀	ftty
舎	thlv
憕	ybfu
鳯	qroj
胈	wsbo
屽	jhgs
揢	aoel
挍	aotw
筽	qlfg
峫	jhcj
柎	feac
廲	ufki
咮	lwti
鴟	taor
罶	mtjt
鼩	rbwl
箾	qmwm
喢	lwrj
誎	uflv
錫	wjwt
鞕	gfjw
骭	mhgg
郉	hhcj
碪	ddxi
漅	ivjf
隣	cpra
蹣	nsfr
饐	yhyu
従	runf
汈	ivfi
誩	uuaa
鳮	brou
瀵	ipjt
驲	xjrm
颺	rjft
蠎	ksgs
凚	sffh
莈	siqh
臛	wdwi
孹	blov
聛	awdi
涢	ilkb
閥	kegg
蝯	kehb
亁	djhv
饗	vqoy
朖	wovn
懃	gsxy
蚖	kfhw
嚱	lmfg
纙	bmbw
喎	lnav
撗	askt
裖	psny
墆	hsfm
抧	alti
恴	ojyi
埑	aeht
葯	sbwo
檇	fwkf
薁	srpg
訄	yuaf
豷	dhyu
蒎	sier
髩	haxv
嗹	lgpd
唒	lgov
衭	pguy
遱	ldlp
觧	ytug
霤	dtjt
噰	lovw
柲	fyqp
雑	yfwi
臅	wmwk
瑽	grtn
虰	kanc
奜	lgdi
懰	ytwm
灺	ucyo
販	mebu
翺	tssx
琫	ggao
鵫	mjro
嚲	ovld
苠	scai
鵄	hrok
硠	dovn
埫	hnst
壌	hotr
癆	puux
祽	hotd
縗	bofr
哬	leal
痙	pfvf
罳	mjyi
佁	evlv
壈	honr
秈	rjsh
媿	cwun
狟	rfjf
睟	motd
鬛	hnwb
棡	fkuj
姌	ckht
罒	mww
垵	hocn
猯	rjsr
楺	fcqf
鬢	hofm
媬	celf
跕	nmlv
鋳	wdac
蒍	soww
瘣	pwub
蟞	umtk
萡	sieb
醝	gufo
迖	spdq
嚘	ldwe
鸀	mwkr
澙	irsu
袇	pwob
塈	xvgh
珢	gvnn
湹	iskk
磠	dklh
睕	morv
攣	ubbt
鳉	qura
慼	dkmy
祻	hndg
灈	immw
睎	mwsm
綷	botd
搇	ator
糦	pdlv
絻	bylq
埢	hugv
廹	exnb
娳	crmd
匁	wwly
巆	juul
柂	fqcy
帰	uxym
铴	tivt
覗	vflm
逹	hudp
磜	dwhs
涗	itlq
箏	qexv
岰	jvxk
蝨	vdkk
祬	hhks
砡	dgod
瞷	mkjr
暡	jtvx
勚	hkxk
柆	fidv
狖	rpxq
萹	sinc
鮣	ttfx
亽	tode
磣	dvvt
骾	mfjw
蕀	sfkk
婬	ceen
焞	uovk
鶒	flxr
紬	bkos
姡	cren
観	qfwm
堮	hlls
粦	prao
慱	ygac
捄	afko
铕	tswy
鵙	mrob
蹆	nvpd
泒	iqus
霡	dwok
膴	wqsu
蛻	ktlq
巛	vcc
籫	qwqm
僽	eruy
貍	ykkk
矱	qswb
鶡	jwtr
嘐	lxxt
庲	udlu
兂	gqrf
檍	fijy
閧	ksti
煟	ujwy
棸	abfv
鷇	hfro
鋡	wtol
艦	qsqm
仴	ewye
謞	uola
宖	ovvv
鸋	oymr
妔	coqj
噅	leww
陁	cqcy
呅	lpwv
襶	pdgt
嘽	llld
鐸	wmhd
唂	lttl
蒞	siei
旹	xfjr
錋	wwwy
鵁	otwr
脃	wycb
哷	leac
噈	lomd
氉	lllr
鋎	wofh
姟	coin
嗰	lend
啋	lefv
縁	bxds
鵷	orvr
謄	wugu
遶	hhhp
吷	lbte
褘	pciy
鏻	wpra
咘	lsmv
斄	hesd
竂	pgum
匋	wwoy
錿	wmuj
幇	hham
陑	csrj
勛	lmxk
鋂	wqbm
団	nacw
犑	wmsq
荙	sgpd
斨	xejp
迌	wpdy
嫺	ckwy
瞉	hfmf
墶	hhup
嗩	lmmb
咺	lfjf
嚾	lslw
蕫	sikk
犡	wssk
鶌	bxxr
癊	pctv
鴽	clro
嚰	lpdh
鶵	wxwr
娗	cexn
嫲	cpan
裓	pgsj
葏	sixa
喥	lusb
冫	siii
袺	phlv
駒	dwlv
叧	lbdv
齄	tjaf
塁	jssh
虌	sumj
鞺	gnht
榎	fdme
藷	suhj
懤	yhva
轀	gntm
頚	bhdm
搳	aodl
棃	rwqf
廄	uxvq
鷑	qiro
刦	hvmd
帡	musj
醕	gojr
檵	fvvx
翍	xxvp
灒	iwqm
稕	rovk
飬	ugov
凔	stol
杴	feiv
岒	jtov
勠	xxtx
箁	qilv
潯	ixfa
柀	fvpv
卭	fxjo
餟	ybbb
讄	ujjj
慩	ygpd
皪	eevf
諳	uijr
踛	nhth
偟	eegn
嶶	jrfq
睳	mghh
黲	nvvt
菮	suxt
鵾	jrrr
檊	fdjh
戝	mggb
歵	nhmb
倈	edle
諝	uvnw
琸	gmjd
枃	fwsi
誜	uvte
歂	jsei
庱	uhte
橢	fcsw
崕	jshh
摻	avvt
廼	dxnx
澩	rwwk
埶	htho
醙	grnb
亅	viii
絏	bkqp
耤	dtsj
貶	mqpe
赯	httl
騐	dtoy
攦	afki
鶅	vjro
耬	dtlc
盺	mejf
扊	iuuo
暉	jygc
赥	htte
耮	dtux
濴	iuuk
氶	vkvi
嶦	jysu
徏	rnma
鶀	rdjo
猧	rnaq
笯	qcbu
榙	fsye
悊	aeyi
羾	xxfo
橞	fgyi
薭	srwd
烢	uoqa
艎	qegn
簝	qgum
磼	dwfv
煃	ughh
麅	iwck
顟	xxtm
箋	qggg
韏	ugci
茚	stfx
鼵	rbps
晱	juuo
鹠	tjya
嵣	juxl
栐	fokv
逎	gpdo
鮛	tkma
醡	gpqm
觴	ytqt
弙	vfau
嶔	jwei
灴	ufoo
踤	notd
炡	ufni
筰	qeqm
矨	qeoi
聇	afni
幍	merj
抭	aoqj
琲	glin
夑	uuue
躂	nhup
鶛	rrer
轏	gbvv
慔	ysjg
穔	rskt
廮	ummc
抋	ayio
褩	qqor
煯	urre
黗	naxg
淈	ibxx
鯈	enet
蒮	sywi
澘	iffj
悆	tffy
帗	msbo
羱	usem
繘	bcql
臽	yrjm
鸓	jjjr
兤	mhut
醧	ggll
歝	mhue
鵌	rtff
鵅	elro
捰	ajfv
纎	bdgf
洅	ifkh
誑	urgn
燬	urfq
觡	ytel
詄	uqgu
叕	bbbb
醹	gdsr
鮕	tdgy
鱬	tdsr
鲕	qsry
儗	erqn
浖	ieac
廩	uonr
焴	uovw
鳠	qswb
緅	babu
伇	eqhe
蚠	tbkc
灀	idfm
仛	eqai
篯	qtfg
滺	ieny
訉	uqod
睙	misq
愞	ysgd
懫	yeem
誂	uqss
逴	mjpd
搉	aywi
舩	qtvv
鳑	qouo
斵	tfje
鷮	elkr
鱄	tgac
歈	tfwe
黽	jmm
恌	yqss
鳪	mroo
鴡	mroi
傃	ehbs
恜	ygfo
膭	wlkm
訟	utvv
籑	qmgv
秨	rqmo
慅	ybok
劊	tfjm
穨	rqlm
舕	ruuo
擉	amwk
扤	ahwo
蠠	gkkc
紆	bfau
忋	ybji
篔	qlmb
瞼	mrlf
祃	hxms
鄈	bfgc
筶	qwlv
絳	beao
罫	mhhm
烇	utgn
偮	elar
僩	ekwy
頦	odmb
颩	rtof
瓽	naws
籇	qods
嶳	jdhh
皠	ejwi
篸	qvvt
瞏	mhlr
鶋	bdro
鵸	galr
蝱	ukkc
焝	utaj
慫	rtty
忔	yqvi
忚	ycyi
炴	ukgd
虅	swud
捸	axkv
羭	utfm
禴	hync
癿	exib
岨	jmis
疎	vnfl
軱	gquc
痏	pswy
氃	ikrm
敼	dlmb
缻	wawo
迊	fmpd
惄	kmby
闝	kmeh
蹌	ntol
襢	ponf
腒	wbdg
紽	bori
膯	wbfu
癝	ponh
厡	sekv
齜	mnri
砅	dkvh
幎	myjt
斎	pths
羣	xqlu
坧	hdht
矼	dfoh
馞	rjdv
冋	klvf
洝	iocn
鯭	tvmn
蒧	sdml
窼	pvjf
扲	atov
壊	hdmr
穵	pvix
懐	yomr
駔	dmim
砠	dmih
庪	uadb
鴢	vxro
薖	snpd
飱	frys
跁	ncbv
掑	adjo
汚	isxi
殾	hjqh
榥	fjmh
玓	gwod
闡	klld
盕	iqom
鵟	rgro
汌	iqcs
鍖	wdxi
痑	prrk
癹	bqhu
窵	prox
橾	fllf
漟	inht
鵵	ylqr
茦	sfkf
銶	wfko
蕚	slls
殞	frlm
綖	bqnx
屩	brel
樻	flkm
悮	ylfg
墠	hlld
鼒	aqmt
殝	frgr
濗	isjm
衏	rfha
鋉	wflv
魎	wfmr
蔿	seww
魜	ttey
髳	hcqp
禢	hjxx
蓨	senw
垰	hkak
敨	ileh
鏄	wgac
垇	hkfi
呰	nrlv
浧	ilgn
殤	frqt
鐡	wdgu
胾	dgkt
瑡	gyfm
雗	djqw
鴗	irod
慟	ywkx
糀	pser
酖	gyqr
頣	sdmb
暦	sffj
楟	foan
諶	udxi
闘	kfla
髪	hsbu
餲	yjwx
汵	itov
揘	aegn
莚	sqnx
眴	mwjr
簼	qash
饟	yosr
劘	plmd
桟	fsgg
鍀	wjfa
譑	uell
邟	oqcj
鱇	tuxk
堧	hsgd
謩	sjgu
糹	bsss
禐	hehb
瀽	iosn
怚	ymii
毰	rilv
渇	ijwr
窞	pyrj
坆	heht
漰	ijww
鮆	nrty
蘗	sblf
涳	ipfo
彍	vust
鵞	qagr
霩	dovc
帎	myqr
虵	kcyc
涾	ikjr
褦	pvwr
怗	ymlv
藳	sorh
騧	dnam
搲	apqu
幓	mvvt
梘	fmxv
牓	touo
礕	blod
銍	whkj
櫉	fsda
粌	pvns
畺	fjff
芀	sbdj
礚	dshm
覌	bmxu
趹	nbte
挀	aery
輶	gugo
犘	pwna
虷	khgc
閨	khht
鋥	wlgn
砯	dokv
馡	rjli
鸔	rjsk
颬	rhyf
灂	iema
溇	ipcn
儺	esfw
玤	gdnn
隤	clkm
尟	jfnq
暳	jddx
訥	ukte
韲	ounf
稑	rhth
犵	rqvi
瓀	gdsr
犎	hhaw
哵	llxm
澟	ionr
嵗	jdfm
鉾	wvwn
傔	euxt
笀	quwk
煱	unao
溎	ifhh
旴	jfau
棝	fndg
髝	ouux
鱖	tsue
谾	ttlf
璚	gcql
谺	ttlh
豀	ttlg
鼈	umtj
鄨	umtc
牗	tuxw
枮	fmlv
笒	qtov
麖	ioma
朌	wtbd
娍	cdvi
猵	rinc
柣	fqgu
杸	fqhv
璒	gbfu
鮪	tswy
齌	ounu
鯁	tfjw
梴	fqnx
瀓	irfg
鲺	qvqk
鉰	wvfl
鍮	wtfm
漴	ijoh
兿	uayv
廈	udme
薔	shtl
漒	ivlk
鯉	tkky
燸	udsr
鼸	rbut
棙	fisq
樺	fsfd
謓	udmt
鼣	rbsq
樕	ffle
秔	roqj
檚	fffn
醤	ueag
聾	iwma
鼱	rbhw
汦	itai
鸉	fjfr
夣	ovmr
桚	fvrk
噋	love
鼫	rbdh
陃	cfkt
沕	iwto
堊	fjht
椄	ficn
衞	rcla
槙	fdmt
桭	fsnv
渕	iugm
漛	iugk
獩	rndm
飃	rdhs
唍	lofh
鄮	tmcj
獣	ijfs
枟	fsvv
檯	fhlh
滭	ijsa
灤	iubf
獳	rdsr
韷	ijxx
戇	ijey
桍	fgfs
贛	ijem
溄	ijea
秥	rmlv
檖	fudp
溓	iuxt
棈	fhwy
覣	rcmx
溋	ivbm
娙	cfvf
柪	fvxk
獆	regd
鯢	trqr
徯	revg
羓	ucbg
邘	facj
誳	ubxx
焻	ujjr
啌	lpfo
柛	fkev
衘	rqfa
籦	qwwk
艭	qwwb
洭	iggn
旽	jaxg
猺	rewo
鏣	wusu
蕥	shwi
枆	frmv
洰	igbu
爂	rkfu
朿	fkfv
穏	rexy
淽	isni
澫	isky
辤	eybo
漙	igac
馝	rjyq
煬	ujft
漘	iswy
阹	chvv
桮	fdlv
諴	udfl
鮌	tovo
泏	ixxg
缾	wusj
鉼	wusj
寉	owib
婭	cfja
敔	fcle
郚	fclc
梣	fjtv
椲	fciv
朾	fanv
溕	iyfd
氿	iyfs
鉁	wtto
渙	iykg
瀺	iylo
鸼	qyao
柅	fbri
蠜	fwwk
労	iyxk
媥	cinc
寏	oykg
鶏	egro
盨	tdmm
惪	dmyi
癰	pvlw
闓	kjfu
瑐	guwm
衱	pvod
祋	hqhs
覔	dmxu
刐	womd
凓	sdfv
圤	hmot
趗	dnvk
鬐	hhrj
婘	cugv
璲	gudp
蕠	sclb
蕯	scew
蜨	kfxn
鏔	woft
蚎	kjrc
弸	vwwy
祾	hhte
芺	seoj
蟕	knrt
埧	hmti
蕎	sell
癬	ptug
咃	lecy
尗	kmas
裿	pgal
磒	dlmb
癵	pubt
蟬	klld
鎁	wacj
嚢	dlyr
鼔	dmbu
賈	dmbx
駞	dqcy
苲	sqmo
軨	gtob
篺	qawd
埨	htfn
芚	saxg
弰	vmwy
鳋	qbok
芐	sakj
蒱	safu
薋	ssem
曕	jysu
凾	vlbx
妌	csti
禣	hfac
赩	httc
鳡	qdfy
胣	wqcy
媖	cskg
苢	sbbu
蟫	kdjd
袦	pxxg
豲	dsem
兣	dqsk
閂	kfin
朜	wovk
脝	wovl
瘓	pykg
郷	vqxc
趍	drrk
転	gsvv
磇	drwr
蛖	kdto
禲	hssk
媮	ctfm
輀	gsrc
蓃	srnb
鐍	wcql
螾	koft
涖	ieid
擪	sjwt
匉	whue
莁	sftt
栔	dbfv
禡	hdms
霦	dfft
鐕	wgqj
婓	lcni
粖	phom
酔	gydi
懟	kuay
鉔	wgmv
魊	wglf
鑚	wggm
豘	daxg
蘷	sfne
癠	pous
鋗	wlwy
裐	plwy
罎	wjdv
礔	dblo
砄	dbte
噸	laxm
咡	larv
覅	dcwt
荂	sgfs
鼛	ddbl
膿	wkss
鉲	wkmo
駓	ddfi
粬	pksj
膗	wjwi
癑	pkss
礮	ddow
砶	debh
駬	darm
錡	wgal
膞	wgac
甹	ksko
疕	prib
蠂	kshf
氀	ldlr
嬎	cylw
馿	diem
瑦	gywn
餈	seys
鄷	ksfc
胉	weby
裌	pgtt
鋮	wdvi
蟌	krey
鷣	djro
匼	gyef
鞈	gyee
迼	hlpd
癥	prfg
斮	sjej
媕	cysj
脛	wfvf
塀	hbus
錽	wfue
髷	hksj
韾	hbqj
钁	wmmb
騹	dgsi
駴	dgsj
砆	dguh
丄	ksss
趬	dhhh
婁	ldlc
粻	pham
厞	slih
窻	prey
藂	sabs
嵺	jxxt
毾	jxxr
箘	qnrh
皫	eiuo
傫	ejbs
偒	ejft
琣	gilv
鬎	hflm
醷	gijy
僶	ejme
垝	hysv
勦	vjfx
烣	usuo
靯	ghte
錨	wsjt
倎	ekst
爟	uslw
沑	ibcs
僤	elld
鲴	qndg
晄	jmhw
迆	cpdy
儬	ehwm
醲	gkss
嵍	cqej
苭	svxk
崀	jovn
嗺	ljwi
椝	gkfv
倴	egds
峐	jois
簚	qmgm
輼	gjmn
伡	ehce
夊	ehhh
倰	ehte
崱	jmmd
湪	ibds
躠	syon
溞	ibok
謋	uraf
陗	cmwy
傛	eptl
嶛	jgum
侐	eqmn
謧	upxv
獂	rsem
輅	gelv
偸	erfv
瑝	gegn
諄	uovk
嵒	lllj
諦	uoum
褁	jfry
渓	iegu
魛	tbdy
螀	urak
浕	ibos
癅	pagj
礨	jjjd
崵	jjft
縏	qqbs
薢	sytw
誃	urrk
儻	enne
膵	wsod
瑓	gfnu
剰	rsmd
侒	eocn
顡	iddm
铔	taue
咢	llfs
皜	eolb
歟	rske
厷	svvo
燫	uuut
箑	qfxn
鼃	hhjm
訔	juas
謐	uyqm
刼	hvbo
薊	stmd
醸	gotr
煥	uykg
琗	gotd
耏	stor
筓	qhhg
秼	rwti
熤	uxxi
襾	dxxx
昤	jtob
廐	uxvq
稯	rwxe
駪	dwqr
噺	life
笻	qfxj
腁	wqhh
筬	qdvi
嗇	httl
乁	viii
鞉	gqss
皯	vhgp
毉	gqqt
輹	gqje
暩	jwhs
琞	jwgo
箣	qfkm
兦	rxiu
岥	jvps
甿	juwt
鏓	wrey
玍	qhtk
鬉	hwxe
鶄	hwro
夻	glvd
鶯	uuyr
盌	rvmn
禜	uuyh
鲉	qkoy
皭	eema
偺	eemj
倃	eeml
鶔	cqfr
仸	eeoe
煻	uuxl
箆	qktr
膍	wrwr
僾	eeye
鲖	qkfl
貣	gmby
麉	hhil
巓	jrmm
猘	rwkm
簶	qhxk
詾	uwwx
驁	hwed
鼇	hwej
佋	eblv
煄	uwkk
箥	qivp
謷	hweu
荓	susj
暵	jsfg
惢	yyyi
瓐	gmjm
耇	hwlv
夆	ednh
齏	ounf
鲯	qdjy
忼	yoqj
纑	bmjm
錎	wyrj
絅	bklv
搨	ajxx
巺	ccft
吤	ltti
摪	axwa
迠	mlpd
趽	nogv
讱	obod
忟	ypwi
撹	aiym
贔	mmmb
斀	mwkb
縹	bdhs
膇	wypd
纕	bosr
綅	bxyb
綳	bwwy
郼	ccji
摖	awhs
繕	buul
邥	yqcj
掕	ahte
慲	ysfr
韖	ccqf
継	bpxi
褽	bhar
鳩	yrof
瞯	mkwy
慴	yxxe
鸐	xxwr
毃	oqhl
忴	ytov
覻	mflm
翖	yxxi
胊	wwlv
羆	mvwu
噂	luga
敃	caeh
邷	acjw
貆	yfjf
奵	cann
诇	oklv
唥	lstb
悕	ywsm
嚵	lylo
鵮	yrro
鷵	bhjr
愵	yvss
呍	lsvv
餠	yqhh
帞	mdjr
挭	afjw
扨	abod
忹	ygni
彐	xll
虖	mqua
髞	ollf
掽	aukg
賂	melv
綄	bofh
繦	bvlk
觟	ythh
懹	yosr
屧	brhf
寕	odma
懝	yrqn
槀	ofvl
撣	alld
抏	afhw
眜	mhof
慯	yqjt
旙	oqpj
扖	aruo
觿	ytjl
児	njqr
宷	oqpm
觭	ytgl
餸	yugp
緛	bsgd
懴	ydgf
抣	awsi
圀	ntog
剣	ytmd
硩	aedh
餻	yuuo
蹏	nemu
搤	autm
慛	yjwi
踳	ngjr
躨	nute
翧	ofjx
龂	ntxe
鋬	aebw
跱	nhac
爼	wwmi
翫	xxeh
抩	akht
呌	lsdi
耾	asvv
纆	bnht
旑	ogal
縧	benf
鵋	byro
龤	ynre
阤	ccyj
眰	mhkf
慳	ysbh
蹳	nbvq
攖	ammc
撛	apra
黤	ngkd
賮	xfum
纞	buby
緺	bnas
揓	aoqc
摶	agac
刵	amdr
撶	asfd
蹜	noej
雟	xwkl
頜	ydmb
糱	xyop
禼	mnwv
焣	abuo
檥	fuqg
梛	fvac
鲹	qvgt
帀	fmvi
袃	abor
掗	afja
銸	waxi
椃	fmuv
鳺	grou
謉	uwua
鳿	gron
襅	pjsa
焤	ueau
肕	wbod
猍	rdlq
瀁	iugv
苆	sabd
鶹	tjro
鎫	wrwe
徠	rdlc
跍	ndgv
蔕	ssfm
纇	pbdm
鸅	mhur
寳	ogym
鼚	ddbh
郣	dyvc
颣	pbdk
匵	ghmm
泬	ipxs
蒣	srtf
涐	iqag
鯤	tjrr
璙	ggum
紺	bssi
鏙	wjwi
牳	wbmn
鼟	ddbu
毧	rgso
攏	aiwm
鄏	sacj
咰	lwjr
燖	uxfa
唫	lwjv
夲	gdid
簗	qibf
狘	rgxi
歴	sffn
讌	usfu
螐	kywc
砳	ddhh
憱	yomd
樥	fsed
雽	dqua
藋	sxxw
襳	pttf
鵱	hthr
艗	qutm
霝	dlll
踑	ndjv
蟓	kyld
胦	wkgd
堥	cqeh
緄	bjrr
檣	fhtl
痌	pkfl
屓	bmbh
姩	cqao
腛	wbhk
邿	hacj
闤	kmfr
蠏	kytw
憻	yonf
鶭	boro
驒	dlld
唋	ltff
慃	ytvx
麔	ieml
瀏	itwm
愩	yfmb
钑	tvod
繎	bwsu
囋	lwqm
骳	mvpg
騋	ddlm
檮	fhva
澊	iuga
囥	noqj
齻	mdmt
焆	ulwy
鉊	wblv
葾	srvy
閮	kexn
搙	asac
斉	ptsi
乭	dvih
冚	yjsm
晎	jsti
嫾	cpra
颕	rhdk
檨	fuse
髶	hara
贜	msgs
夅	eaoh
盽	mdnf
賷	dllm
蕣	seya
栟	fusj
撌	alkm
煡	uxax
鴶	hlro
碀	dyxv
嘫	lwsu
秇	ryod
貽	mvlv
売	hyqr
濅	ioxb
溈	ioww
寗	oyqh
鶺	sstr
禕	hcis
顢	sfmm
穋	rxxt
倄	ewsw
鏕	wilj
瞔	mhmb
猦	rrfq
槂	fvqb
郰	abcj
禸	kvvf
鶨	bdro
矐	mdwi
簹	qnjt
誻	ukjr
蠺	fgfk
臕	wiuo
鶬	toxr
墫	huga
孆	cmmc
傰	ejww
嫭	cmqa
蚹	keac
坒	rrht
縶	hudb
俈	ewlv
襘	ptfj
癐	ptfj
杍	fvkv
躉	sknv
瓟	qwck
騺	hudd
蒭	swxx
朡	wwxe
縆	byff
堔	hytf
頨	xxdm
凁	sflv
敎	wsve
璖	gigf
畵	xhjx
閞	kvsj
樞	fgll
弶	voma
桇	clfv
匽	gjcn
蹫	ncql
碆	ivdh
鶠	gjcr
靱	gbod
靭	gbod
諀	uwdi
譮	utfj
縋	bypd
茐	swto
諰	ujyi
挴	aqbm
礘	djvu
夘	rxjk
煏	uflj
戩	fvvg
妠	ckte
孮	vohs
浾	ihtt
鬙	hujj
濈	ilag
憸	yrli
悧	yrmd
幱	mkfu
涍	ihvk
詆	utao
挱	aimq
塴	hjww
杕	fgdv
鈩	wiej
麨	demq
簂	qngf
堿	hdfl
垹	hdcj
蒁	sfop
閡	koin
詷	ukfl
怇	ygbu
錉	wtaj
潡	iove
錆	whwy
茿	sfqo
骉	xxxm
縝	bdmt
闃	kmsq
鳹	tovr
鶆	drol
窶	pldc
恑	yysv
暔	jdkd
碶	ddbg
碙	dkuj
鴀	drou
佀	ebbu
蜪	kwwo
鵗	wsmr
礏	dkut
苪	sfkt
搃	auly
灔	iksc
鵧	usro
傪	evvt
巠	fvfo
歑	mque
謱	uldc
箛	qvqu
妵	cogn
醎	gdfl
烍	uwqr
鱎	tell
窌	ptmx
蕑	skwy
秢	rtob
腨	wjsr
嫙	coqn
湴	iukg
栁	frxj
巎	jdme
癇	pkwy
譂	ulld
悂	yrrh
鑤	wjsk
崸	jdmb
頳	httm
銢	wskv
魓	wjsa
翽	ndfx
囪	rtod
曞	jssk
帓	mhov
浻	iktl
娋	cmwy
溵	iexq
簆	qofb
譵	ukua
礖	drst
輮	gcqf
鸤	byah
鼉	lljj
籿	pacm
撀	hbqt
圛	nmhd
腜	wssf
皗	ewhl
鄊	vqac
摡	axvq
贀	gqqm
埱	hkmb
藗	sflp
坢	huao
鍉	wjfn
簱	qodj
喌	lliq
螝	kwuc
锠	tjjr
犕	wsqt
鵛	fvfr
刴	vfmd
爓	ukyr
攋	aflm
阓	plkk
洣	ipms
恟	ywwx
鑬	wsqm
滸	iuqd
竝	iidd
麫	deax
麐	iplv
搹	afln
禯	hkss
騁	dksk
醘	ghvm
铥	tevv
瓙	ghvu
橖	fnfv
霚	dcqe
唖	lalf
蒬	syyo
斚	vvyd
鴮	gfsr
湋	icis
埻	hovk
恲	yusj
齢	npxb
鱨	tnrj
傚	eote
歜	mwke
誋	ubyi
儴	eosr
濿	issk
囩	nsvv
鶗	jfnr
鷏	dmtr
鵴	wpro
溤	idms
軪	gvxk
覸	kjmx
敇	fkeh
鞵	gevg
厀	ftkx
眣	mqgu
鑔	wowh
篏	qsse
糐	pfac
渘	icqf
窂	pwnx
儜	eoya
葖	spsq
砊	doqj
縕	bntm
皻	mmvp
靽	guao
誶	uotd
伭	eovo
汱	isqs
図	nswl
蠿	vvfk
徔	rspe
螘	kjfu
埣	hotd
楬	fjwx
媌	csjt
唭	ldjv
韙	jfnc
琟	gwin
輢	ggal
鬳	mfln
喕	lgiv
譻	mmua
鴾	vwro
渨	ijgf
綟	bisq
鑒	sqmw
旝	oqtj
謬	uxxt
尌	dacd
濸	istl
軥	gwlv
燲	uxxm
鸄	eoer
逓	esmp
鮯	tyey
祊	hogs
脌	wqao
煒	ucio
紁	bbod
鮸	tylq
鸍	ftmr
鮂	tnte
筈	qrek
鞄	gwck
玸	gwck
鷜	ldlr
籨	qrei
鶝	fljr
儃	eonf
蕋	snnn
鶦	dwro
蘛	sdxw
妉	cyqr
鑋	gfvw
檻	fsqm
鸕	mjmr
霫	dxxe
溡	ijha
鳻	tbro
牜	wnnn
悳	dmxy
丼	sobj
痽	pwib
揕	adxi
鸒	rskr
歍	yeiw
欱	yeie
謴	ubdm
奱	ubbg
甗	mfla
棔	ftaj
薺	sous
綃	bmwy
珷	gfgn
罌	mmwo
岇	jtxj
絫	vvvb
汥	idbu
冪	ysjm
雘	wosb
掿	assl
荄	soij
餎	yelv
枏	fksi
縂	buly
趤	dodh
晇	jgfs
暛	jufo
藛	soru
嗘	levg
皃	eqrb
睼	mjfn
鴩	qgro
瀒	idfl
覍	mmxa
嗂	lewo
盚	fkom
鸞	ubbr
葹	soqc
騝	dxax
渂	ijpw
欍	fswr
躈	neoe
鵽	bbbr
腙	wohs
偫	erha
朲	ftev
轷	hqua
漄	ijsh
髺	hrea
糑	pvss
飫	yeos
峬	jfus
觕	wytn
酑	gfau
犉	wovk
哣	lflu
剢	domd
譒	uqpj
鰂	tmmd
膼	wnpd
憪	ykwy
慙	geyi
檝	flag
炚	juor
讁	uoup
謗	uouo
瓬	oawg
繸	budp
饍	yuul
隀	cwkk
薣	sddb
撁	aovw
猼	rfac
鰬	tmpw
瓪	aebu
遅	bupd
帋	tamv
餪	ysgd
襂	pvvt
恏	cvyi
挏	akfl
辵	tnfo
钶	talv
蛣	khlv
廦	ublo
稾	orhl
抐	akte
穲	rfki
硋	doih
溰	ijfu
蕝	sbyc
啺	ljft
竉	piwm
攰	dbxk
鄼	ggmc
廽	msxn
蕧	srqe
忈	syii
轇	gxxt
蹢	noud
譳	udsr
鯨	toma
軵	geac
覰	mmmx
単	ijdi
楄	finc
鴔	qpro
觤	ytyv
憺	yysu
鱧	tksu
熞	usbh
庬	udto
汃	itis
黵	nysu
繏	bcct
鑷	waaa
亷	iqxt
萯	symb
趘	dbrm
葂	sylx
厱	srlh
莬	sylq
瀲	ireh
奬	xwag
鰅	tkyy
髄	mswp
眑	mvxk
撽	aeoe
跈	ntto
諑	udod
塉	hssw
轣	gsrn
馭	dbum
鉌	wrhj
昅	jvod
竪	sbid
眂	mtai
稢	rglf
筄	qqss
獉	rgrh
釡	twji
鰶	twhs
楕	fsfw
桜	ficn
馽	dlns
撧	abyc
膬	wrrr
襚	pudp
袽	pclv
茘	sbbb
槞	fikd
峟	jswy
瓂	gshm
帉	mtbd
呇	klvv
冾	syei
堽	hmfn
鼘	ddbf
誖	udyv
輭	gsgd
勲	wkxu
頾	tdmr
弣	veac
贕	toom
蔠	sbes
鶶	uxlr
鮈	twlv
汷	iehs
彺	rgnc
彡	too
昸	jesi
觼	ytye
厤	srrh
妀	bcnj
鋵	wrqj
刌	amdc
轕	gsjx
擽	aevf
腉	wrqr
霿	dcqm
鍇	wrre
婜	sbcn
腇	wrcn
遉	mmpd
蹹	nyxx
婲	cser
稛	rnrh
摿	atij
茷	segg
憹	ykss
輚	gggg
鐶	wmfr
羬	udfl
噊	lcql
窚	pdvi
籕	qftj
罼	mjsa
硄	dmhw
瀖	idwi
趡	dwik
鼂	jfjm
鷞	gwwr
啩	lhhm
蝁	fjkc
鑼	wmbw
饑	yvvt
瘚	puxe
璯	gtfj
伵	enqr
閩	kkcn
鵖	xvro
掄	atfn
釂	gema
璗	ijfo
輳	ggfg
鑢	wmjy
墯	ysfh
鰼	txxe
蘤	seew
屼	jhws
琋	gwsm
硞	dwlv
鯽	txvx
餃	yotw
啳	lugv
鹝	flky
謵	uxxe
詺	urlv
惏	yffv
鞌	ocge
篬	qtol
漇	irnn
怘	dyig
嬐	crln
贐	mxfm
纓	bmmc
鉙	wlti
慻	yugm
劗	wqwm
矺	dqai
臶	hsnv
涽	itaj
鵠	wlro
囨	nduw
瓆	geem
胏	wqxq
叞	bhbu
泜	itao
搝	atsq
癗	pdjt
胻	wrah
剳	symd
惎	dyij
崳	jtfm
翪	xxwe
鰎	txax
廵	vxnc
誽	urqr
紿	bvlv
盋	sbom
怞	ykoi
薥	smwk
珛	gswy
懢	ysqm
魣	tcuy
澰	irls
掍	ajrr
榯	fjha
鮟	tocn
黮	ndxi
璕	gxfa
恈	yvwn
姠	crnn
砇	dpwh
藅	smum
婰	ckst
阠	cvdi
幏	mods
屴	jxks
姸	chhg
桪	fxac
鄅	qlkc
僫	efjy
榗	fauj
壻	hvnw
蕘	shhh
鸆	mlfr
鮭	thht
瀫	ihfb
喍	lnrf
鶞	edmr
葨	sjgf
剸	gamd
鷢	suxr
餄	yyes
徥	rjfn
桻	fedn
湗	ihha
杝	fcyv
盁	vmnj
栞	hhfv
簒	qmgv
顇	ottm
噿	lxxd
蔪	sgej
鈛	wggj
鷅	dfro
銼	wtth
櫱	xyof
毱	rwpm
硜	dfvf
錬	wfjr
棊	dfvj
悀	ybtn
祰	hwlv
鷎	egdr
祍	hens
峮	jxql
镺	heoa
鼰	rbmb
蜁	kqvn
蘯	sijm
埬	hfjr
昹	jokv
妋	cgun
艃	qkko
蟨	suxk
喰	lysv
菒	sjfv
熸	ugqj
嚁	lxxw
椈	fwpm
篅	qjsr
哫	lnvv
甖	mmaw
鳭	brod
烮	frmu
袏	psfo
肨	wdny
煫	uuds
塜	hyfd
眿	mokv
揷	awrj
橉	fpra
詍	uhia
芲	stri
惽	ycaj
槢	fxxe
櫽	ceff
屗	brac
彚	xyjf
怋	ycai
遰	sfyp
攆	aggg
鷷	ugar
薳	shlp
廯	utug
卄	sjjj
鷧	hyfr
鴍	prow
髼	hedn
褢	owry
鎛	wfac
瞃	medm
駌	rvdm
湬	rukv
伒	eeje
聦	awty
噣	lmwk
匟	goqj
娞	cecn
濏	iggq
魌	wdju
鹺	kufo
涒	ixql
櫫	dhjf
荮	svac
娿	calc
鈦	wgod
諟	ujfn
媓	cegn
跜	nbri
暰	jrtn
鬩	nrqr
扗	ahto
窽	prqe
嵷	jrtn
甋	ouka
罙	ytfv
屢	bldc
鴐	xlro
鸃	ruqg
篳	qjsa
嶰	jytw
幮	muda
汮	iwsi
鼤	rbpw
蓴	sgac
幨	mysu
顑	dflm
虆	sjjb
宼	ofhc
蒔	sjha
樆	fpxv
逈	rpdn
艫	qmjm
鬂	heft
臝	ujfv
簘	qxpt
酧	goac
冐	kswy
窲	ppsd
焭	uuyq
葓	sist
鈃	wfsj
齵	mkyc
臷	dghk
崪	jotd
垺	hevk
儞	eftw
祤	hxxi
娕	cflv
勥	vlkx
挘	amqx
靋	disn
蚔	ktai
腯	wedm
鼮	rbex
鞏	fqog
燓	fwwu
俓	efvf
鏉	wfle
飈	ruuu
硙	djbj
鯥	thth
姴	frmc
妅	cfon
槪	ferq
鵿	rjqs
飦	yhgs
飶	yyqp
壟	iwmh
梮	fbvl
穅	ruxk
嶍	jxxe
耊	hhkt
埀	wurs
膋	uuyw
鼭	rbha
胕	weac
哰	lown
痵	prvk
賍	muht
餼	yqpm
惵	yhfv
栄	iyfv
叺	lruv
仮	eebu
駄	dgod
緉	bfmr
痗	pqbm
勯	onlx
蛓	dgkc
豰	hfds
譀	uvae
佂	efni
牕	trey
煔	uuml
氼	ktev
覢	uumx
橎	fqpj
稴	ruxt
龘	iwmm
袘	pqcy
粚	pqcy
隬	cftw
鋄	wfub
竚	ioan
汋	iwod
圗	nvds
湩	iwkk
灪	ifwt
莤	sgoj
鄛	vjfc
膹	wdsm
媔	cgin
蠨	ksxf
嬁	cbfu
鬶	gkfn
脻	wfxn
朥	wuux
铹	tsyx
龎	siwm
揫	rutu
瞮	move
鑕	weem
鶽	wdro
弆	hvsj
憖	dsyi
涱	ihas
奿	yocn
粵	rqps
枑	ffbm
羇	mggl
挆	aqfv
鯆	tfuy
碮	djfn
竏	iwkd
楤	fwty
僲	edra
疁	jxxt
蘢	siwm
蜲	krcn
趝	dtoy
躃	nblo
楥	fehb
覦	tfwm
酟	gmlv
銾	wfkv
鼶	rbem
靆	dsvp
竘	iwlv
爀	uhtt
鼨	rbes
咜	lori
鋭	wulq
鶻	mrog
抂	agno
紩	bqgu
蟏	ksxt
烖	dguo
掝	aglf
眓	mgxi
靉	dsve
禱	hhva
廧	uhtl
蝃	kbbb
泃	iwlv
岮	jori
鞜	gkjr
苿	shej
熷	uujj
鋞	wfvf
鶾	djqr
鷒	garo
抸	aqpe
鴱	swro
菎	sjrr
渹	iwua
閼	kots
蝡	ksgd
粓	pssi
釟	wtij
墌	husu
灊	igqn
鞟	govk
嘄	lrfv
剻	jwwm
壗	hxfm
椑	fwdi
艍	qbdg
阫	cduj
鷋	stfr
捼	arcn
娏	cdto
蜄	ksnc
沇	ivqr
滆	ifln
衊	qmso
朎	wtob
魠	tqai
侹	eexn
肁	ixao
幦	blom
櫺	fdll
萮	stfm
鵺	oerr
岝	jqmo
幝	mlld
娨	cjhg
槮	fvvt
醔	rugo
鸙	ynro
愓	yjft
弉	xhsj
頇	hdmb
鞹	govc
諯	ujsr
穈	prha
簙	qdfa
儌	eeoe
籘	qwub
朩	fvvv
兾	ujst
鷽	rwwr
臹	hdvi
讐	wwua
鑞	wvnb
岧	jblv
薌	svqc
祶	huvq
皵	sjvp
湑	ivnw
喼	lyxy
恅	yhri
摠	arey
埲	hgao
愭	yhrj
鈒	wvod
踂	naxi
箎	qmuk
稝	rwwy
躣	nmmw
墐	hgsi
鰍	truo
橔	fove
筁	qksj
褱	omkr
荺	shws
鄔	ycjw
蟎	ksfr
垏	hxao
庤	uhac
嗼	lsjg
膎	wevg
伻	ehue
潐	iwuo
虙	myqp
爕	uuuu
椊	fotd
髤	hfva
瞡	mgmx
嚃	lmkp
鯗	ugty
翜	xxgt
鶟	psro
鼲	rbyg
簳	qdjh
媦	cjwy
諫	ufnu
鷀	uvvr
鉚	wtmj
魿	ttob
伃	ecue
溙	igkv
垔	dhtx
欿	yrei
粍	prmm
翭	xxeq
徸	rikk
舠	qbdo
羥	ufvf
佹	eysv
鳦	rvio
鴃	rbte
褷	prnn
纚	bfki
弮	ugvg
螆	kuvv
褃	pnwy
彛	xpts
蒀	sjmn
鞙	glwy
眅	mebu
殏	frfo
瀋	ioqj
坣	nhts
瑥	gjmn
螶	gbkk
淜	iwwy
粯	pmxm
綍	bdyv
櫴	fflm
盭	vhum
辺	bpdd
勌	ugvx
憼	swly
醊	gbbb
鬊	hgjr
銕	wgvg
擳	aqxx
銬	whsk
馹	djrm
箵	qmqm
羢	ugso
迉	bpdh
黁	prjr
摍	aoej
薵	shva
鑀	weye
痟	pmwy
鉞	wgxi
愷	yjfu
禌	huvv
擷	ahlm
囒	lsku
鵀	eero
谹	ttlv
諜	uhfv
徤	rxax
郶	illc
暅	jyff
晀	jqss
牅	xuxw
噄	ldbb
裲	pfmr
紲	bhis
啒	lbxx
罏	wmjm
秄	rvkh
雃	fswi
琹	ggfv
抇	ajro
褹	phto
涊	iboy
擧	rskt
潁	rkdm
轐	gkug
隟	cvjf
歁	dxei
鶪	msro
絓	bhht
旐	oqqs
乆	xtei
襭	phlm
銧	wmhw
皉	enri
嵲	jtfv
潶	ines
綸	btfn
矹	dhwh
飤	ytes
喸	flri
嘺	lell
緖	bhjo
綆	bfjw
畖	jqut
叄	vvvf
甒	qsfa
暣	jqpm
笶	qqik
鉂	wlwl
脮	wecn
鷗	gllr
徢	rfxn
擖	asjx
敺	gllb
藞	sddd
圲	hwkt
臠	ubbt
覑	tmxp
佌	enri
磆	dmgh
暙	jgjr
攱	idbu
誁	uusj
釃	gfki
絿	bfko
踋	nhvx
軭	gggn
焿	uuxt
恔	yotw
謻	urrr
鵣	flro
彯	dhto
蔃	svlk
鉖	wesi
卙	dxdi
蓗	srdk
穖	rvvt
砕	dydi
鮞	tsry
鋀	wflu
癓	prfq
瓉	gggm
硤	dgtt
峑	jtgn
簀	qhmb
藢	srfg
鉒	wogn
碅	dnrh
梠	fllv
芓	svkj
粩	phri
曫	ubbj
譺	urqn
鍭	webq
荈	srao
飮	yeis
閕	khyn
鹒	uxty
轛	gkua
夀	svla
舤	qqod
竸	ijqq
軝	gtai
竼	qqod
梬	fksk
翲	dhxx
伂	efmv
裧	puuo
葈	svlf
僠	eqpj
喡	lciv
霟	dist
蕸	sbsp
憉	ydto
刢	tobm
蒶	sbtb
眕	mtto
夞	rmlr
匬	gtfm
螌	qqkc
喺	leqb
熈	qscu
蘶	srcw
臏	wofm
乣	vxio
蜏	krvj
灹	uqai
霔	diog
壒	hshm
刋	wmdk
柹	fqxq
繒	bujj
藀	suuu
撟	aell
濭	ishm
裬	phte
頍	dbdm
峷	joxs
琖	gggg
貹	mwgb
塺	phta
蜹	kskt
擫	asjs
錠	wofn
劮	qgxk
搘	ahrj
韗	cygc
戣	bfgg
敀	eehb
殜	frhf
猻	rvqb
堄	hrqr
軎	glvc
淲	imus
莣	suyi
脡	wexn
甴	nksw
蝹	kjmn
椼	fria
澞	imlg
懠	yous
斣	mwkd
磧	dhmb
旇	oqvp
僿	eosh
塋	uuyh
蒘	sclt
卪	xodj
懻	yurt
戓	glvg
妿	xlcn
俉	efcl
癁	prqe
嗴	luxv
砞	dhoh
摓	aedp
姺	cwqr
襫	pgdj
郟	gttc
瀡	icsp
掦	ajwt
魫	tyqr
鎼	wmtu
恵	fkyi
諉	urcn
庁	uanu
畐	fljt
祡	nrhs
蹞	nrdm
罸	muac
羳	uqpj
熂	uqpm
歅	dhei
嬔	cylw
荾	svte
圠	hxit
盬	sqdm
瘏	phjr
鰞	tywy
仒	tsie
釪	wfau
翏	xxtt
罭	mglf
傗	eovj
愥	yskg
粏	pgod
迯	rmpd
頋	svdm
鏿	wnfv
僸	effh
湨	imsq
藭	spwv
哤	ldto
阞	cxkj
頼	fldm
儊	effn
萕	spts
拰	aeen
怣	qgyi
殑	frdq
郀	gfsc
藦	sptu
賥	motd
痷	pgkd
籺	pqvi
幑	rfmv
綌	bttl
嵥	jraf
澕	isfd
緃	bttn
趌	dhlv
澦	icdm
殰	frhm
髖	moso
鷪	mmyr
殱	frdf
筣	qrmd
緮	bqje
蠝	kjjj
諢	uygc
腡	wnay
謌	uall
紾	btto
錮	wndg
驍	dhhh
籞	qrqh
丆	dhhh
斿	oqvk
艓	qhfv
紷	btob
蔯	scfj
粔	pgbu
昦	jgti
綔	gfsb
鍞	wmmb
魺	talv
絊	bffi
涀	imxs
騼	dilm
磟	dxxt
驑	dagj
鱮	trst
睘	mflr
軑	ggdc
湦	ijwg
咍	lvlv
鍘	wmmd
畓	kjtv
瞕	mijd
疺	pqpe
謶	uusu
殣	frgs
潻	irtk
孨	vvvk
濎	imxt
帠	rmvj
蠵	kjwl
舝	cvya
詣	urjr
趈	dmlv
犗	wodl
暽	jpra
葽	sdcn
鸇	onlr
縖	bodl
駆	dgwl
嘒	lddx
夰	gtid
疄	jpra
蔛	sytd
玐	gtin
賙	mwhl
睭	mwhl
訰	uaxg
翷	prax
窐	phht
劥	oqxk
詡	uxxi
薝	sysu
溌	ibsq
僒	epxl
鵔	rvte
耈	hrwl
帊	mcbv
屔	efbr
烻	uqnx
蟩	ksue
抪	asmv
旼	jpwr
謥	urey
侅	eoie
懜	ysmr
劯	dxkh
騽	dxxe
嵤	uuyj
颸	rjyi
譶	uuua
熁	uxxw
黷	nhmm
陒	cysv
歽	frej
贚	miwm
葘	svfj
夈	epmh
宨	oqss
蜫	kjrr
疿	pvti
鐣	wntu
懚	yefy
缿	wefl
婤	cwhl
琀	gtol
倸	eefv
瑲	gtol
錹	wnwy
緈	bhud
軰	urgc
霘	dikl
宻	obuj
揗	aedm
蜧	kisq
誀	uara
譭	urfq
儐	eofm
謚	uutm
飇	rsss
噡	lysu
殀	freo
竮	ibus
嗈	lvlc
趉	dxxg
尀	glac
雫	daky
軚	ggod
鷾	ijyr
熽	uxtf
袸	psnv
盠	bdmn
皢	ehhh
銲	wjhg
爯	ekht
鎬	wolj
蹥	ngpd
壆	rwwh
僉	rll
尩	tqgn
襙	pllf
璑	gqsu
潬	illd
湸	ioqj
豂	ttlt
浀	iksj
鋱	wgyi
劦	xxxk
忦	ytti
魒	wdhs
藎	sxfm
捹	agds
鯳	tuto
摲	agej
裶	pliy
繗	bpra
琁	gqvn
粛	xpti
軯	ghue
佒	ekgd
寊	ommb
伳	ehie
黌	rwwt
甛	ssre
垿	hucu
覶	ebkm
詅	utob
儥	ehmm
湙	ipgd
繂	bovd
銒	whhg
猟	riqa
蟐	knmv
蚐	kwsi
糮	psqm
麳	dedl
皟	ehmb
淟	ikst
瞖	gqqm
乚	xii
瑿	gqqo
鷖	gqqr
熗	utol
誝	utol
闣	knjt
鏺	wbvq
艑	qinc
洂	ipis
觗	ytta
樃	foxw
皼	hyfv
鱔	tuul
燾	hvfu
俋	elcb
饛	ysyd
犦	wjsk
丵	kudi
診	utto
倛	edje
豶	ddsm
彾	rtob
齸	mutm
豃	ttle
蚏	kwyc
顕	jkdm
濶	ikre
徍	rhht
瘄	psjr
溳	ilmb
踁	nfvf
簴	qmkt
伅	eaxg
棅	frxl
弚	uvns
簜	qijt
釼	wbod
鎅	wjtt
硺	ddod
萚	saba
纀	bekg
炂	utvv
氜	qjrq
襉	pkwy
巁	jssk
瀤	iomr
蘠	sxhl
傤	edgh
銯	wbsj
餶	ymgs
鴜	nrro
篰	qilc
摦	agfq
秷	rhkh
轖	ghtl
峏	jsrs
傸	egww
埊	jkht
菍	stoy
胒	wbri
赬	httm
攡	apxw
谽	ttll
遖	dkup
閔	kpwn
彮	ptlt
湥	ipsq
亐	sxii
蓸	ssjj
晍	jkfl
旚	oqdh
賶	mtol
湻	iojr
曱	jnsr
珘	gqon
絍	been
疻	plti
蚾	kvpc
帾	mhjr
覟	hymx
珻	gqbm
欅	frst
蛝	kvnc
滀	iovj
痁	pmlv
蝑	kvnw
鉝	widj
髐	mhhh
彸	rtvv
挳	afvf
椗	fofn
鎃	wier
詏	uvxk
螁	kvpd
翢	whlx
貜	ymmb
蠐	kous
懯	foey
乹	djxi
凪	qnij
翬	xxyg
偍	ejfn
侾	ehvk
銡	whlv
梐	frrh
曅	jsfd
垪	husj
媝	rucn
鐋	wijt
筧	qmxk
錴	whth
舏	rxge
曣	jsfu
辡	ooxx
灻	huot
傡	eiid
榟	foox
憰	ycql
皅	ecbb
翆	xxyd
穽	psti
覝	humx
諭	utfm
鏏	wddx
蚢	koqj
珳	gpto
惥	rtyi
磪	djwi
乿	ebxi
瘧	pmxl
蟺	konf
摝	ailo
俧	ehyi
薈	stfj
肔	wcyy
蟧	kuux
鉣	whvv
曄	jsfd
掱	tttu
胿	whht
旊	oqaw
杁	fruv
巏	jslw
騜	degn
蛢	kusj
卌	ssss
紌	bdos
鍺	whjr
槒	fovj
嶯	jlag
淧	ioyq
磵	dkjr
拸	arrk
訽	uwlv
徎	rlgn
惗	ytoy
屖	boxh
愇	ycii
酼	govq
郔	qnxc
蚼	kwlv
盳	muwf
梈	fovl
爢	pluo
趩	djst
輈	gqoc
埆	hytn
銈	whht
珱	gicn
麩	degu
澲	ikut
攟	ainr
謺	hudu
磎	devg
豯	devg
僪	ecql
襗	pmhd
昷	jmnr
犃	wilv
麷	deju
侭	ebos
嚍	lxfm
鱻	ttty
殠	frts
愘	yoel
赾	dejk
芶	swvv
葋	swwl
壱	hyri
掜	arqr
聣	arqr
嵓	jlll
紱	bsbo
鷙	hudr
酘	gqho
釹	wcnj
嶱	jsjx
浶	iown
錑	wisq
蝏	koan
韇	ghmm
籚	qmjm
菆	sabu
幚	dcem
磓	dypd
崏	jtaj
睧	mtaj
蟂	krfv
絤	bdxs
狥	rwjr
贂	mvvt
鱣	tonf
衂	qmbo
臋	bstt
脭	wlgn
鶣	inro
霳	dcew
萖	srqr
斪	wlej
鵻	rwio
莵	srqo
鯓	twmy
揋	ajgf
喗	lygc
鯘	trcn
韈	gsmo
秱	rkfl
螥	ktol
踾	nflj
覲	gsmx
旓	oqmw
殬	frmd
闠	klkm
譄	uujj
賛	ggmb
雺	dcqp
氎	jjjr
觓	ytxg
儩	emjt
樠	fsfr
淾	wkvj
鷭	qpjr
壾	dgbu
尯	dysv
駏	dgbu
賐	mvte
崺	joqc
潕	iqsu
閭	kllv
黓	ngye
稶	rglt
奀	dgdu
尦	tqwo
腢	wkyy
摕	asfm
驈	dcql
踈	nflv
暶	joqn
鈢	wfvj
胢	walv
焎	aeuo
仯	emqp
抍	aqsj
氋	syfr
剗	ggmd
嚩	lbfa
燁	usfd
闁	kknn
獑	rgej
硽	dgkd
顨	dmda
屪	bogm
黣	nqbm
尶	hsqm
瑹	gstf
澁	innn
壏	hsqm
藒	srjx
偹	enej
瑃	ggjr
皹	vygc
萫	srjr
価	edxe
蔎	suqh
巄	jiwm
曨	jiwm
羙	uuog
闑	ktfv
壥	hsnh
齫	mnfv
諛	urte
脟	weac
猐	ruxi
耉	hslv
嘇	lvvt
嘰	lvvt
跊	nhev
秪	rtao
毚	ylro
塂	hstc
趂	dyma
垉	hwck
蛧	kkww
獧	rmfr
畟	jteh
髱	hwck
酨	dggo
綬	beyb
皬	edwi
沝	kkvv
髸	hsti
鯮	tohs
俌	efue
襒	pume
琑	gmwy
牎	twty
涹	ircn
幈	mbus
璓	gsrv
萉	swcb
旜	oqof
黚	nssi
甞	nssi
晑	jrnr
縤	bhbs
蒦	swbu
賚	dmbl
蝐	kksm
侊	emhw
魵	ttbd
胟	wbmy
瞂	edmo
毨	rwqr
磩	ddkm
懅	ymds
韽	tovj
觘	ytmq
纒	bskh
劽	frmx
醏	ghjr
偆	egjr
藰	stwm
騏	ddjm
皩	egjh
邌	rwqp
奲	ghjd
譙	uwuo
尣	tqri
靾	ghie
襇	pkjr
跠	ngvg
驔	ddjd
鐦	wkfs
觙	ytvo
钃	wbkk
臦	sscc
恱	ytvq
庿	usjt
洬	iqfr
偭	egie
篹	qmgv
赮	httb
盙	fmnu
卥	mnto
汑	iqai
綋	bosv
銞	wjwj
彜	bpts
剨	ddmd
貭	edmb
浨	iofv
駷	dflv
滖	iofr
敽	elkb
黋	mhst
懬	usky
拲	sttu
繑	bell
箤	qotd
螉	ktvx
堩	hyff
碽	dfmb
暒	jjwg
爤	usku
粙	pkom
蟉	kxxt
骿	musj
焫	uskt
蛠	kxxx
熿	uskt
灗	ikof
腗	wkaj
鉀	wkjj
衸	ptti
剱	ytbo
饎	ydlv
亱	oejf
囸	nfni
錛	wgds
錣	wbbb
忩	tvyi
喠	lwkk
薠	sudm
攨	apqq
彴	rwod
輨	gobb
蓷	sawi
肬	wdoy
仌	ttee
蠭	edpk
衜	ruta
錪	wkst
萅	saxj
顥	jomm
槷	hthf
龥	yndm
燇	uuga
坲	hvti
碭	djft
訆	uxga
醼	gsfu
圌	njsr
毜	rmam
趧	djfn
閴	kmbn
靏	dywr
栕	fscv
欔	fmmb
傎	edmt
濌	wkkj
綩	borv
艼	sanj
竌	iqjd
蒠	styi
謈	jstu
盿	mpwf
伿	elti
漡	iqjt
罆	wbdm
嚹	lwma
豜	dfsj
廱	uvlw
鮽	ttff
韱	ttgf
炲	uvlv
詒	uvlv
竬	iqlk
闟	kyxx
牏	ttfm
獷	rust
穬	rust
槕	fmjf
蠥	xyok
牰	wkon
衇	qmer
袨	povo
黳	gqqn
悜	ylgn
囦	nkvw
緭	bjwy
侚	ewjr
忷	ywxg
潱	ihyu
鄽	uktc
萺	sksm
樔	fvjf
鏧	hbqw
惾	ywxe
杛	fvgv
韒	cmwy
駢	dusj
藾	sflm
斢	sktd
爮	ewck
埾	abht
葍	sflj
嘳	llkm
眒	mkef
稡	rotd
駾	dulq
儹	ewqm
坱	hkgd
镼	hbxx
齃	tjax
鬝	hkjr
肎	ywym
莕	sflv
緪	byff
鋩	wsuw
瀠	iuub
夿	gcbd
菛	sknj
聧	abfg
沗	fgkv
虣	fgnm
噟	uewl
仐	tdie
暿	jdlv
誹	ulia
矑	mmjm
磄	duxl
鱦	tjmy
捝	aulq
髗	mmjm
唈	llcb
郆	hlcj
袔	palv
橑	fgum
喐	lswc
钄	wsku
幩	mdsm
菄	sfjr
頡	hldm
煰	ulll
弿	ostv
礇	drpg
繀	bjwi
絀	bxxg
籒	qaaj
鶚	llfr
桗	fvfv
黬	ndfl
覭	yjom
顎	llfm
橬	fgqj
魤	teri
墣	hkug
峼	jwlv
瀙	iifm
撯	aumf
斊	parw
鲏	qvpy
礠	duvy
戁	sfly
醱	gbvq
彵	rcyc
圸	hjst
戹	ivie
饜	sjwy
恉	yrjr
亼	tfie
禫	hdjd
侰	exql
礈	dudp
瓲	aaxg
颻	ewrf
泀	ivfl
忕	ygdi
耴	axir
遻	llup
杤	ffwy
稸	rovj
塟	sfrh
鞀	gblv
謁	ujwx
錀	wtfn
噧	lsky
軽	gbht
挮	auvq
惖	jwty
鷨	sfsr
撏	axfa
嚙	lmcv
愅	ygei
黶	sjwn
餳	yjft
淕	ihth
洓	ifkf
聑	aarr
繲	bytw
桱	ffvf
笿	qelv
壩	hdgw
呮	llti
裦	otfr
嶐	jcew
峹	tffj
滼	iffo
骩	myfg
亀	yjkd
鼖	dsdb
蕳	skjr
摜	abdm
寜	oymv
檶	fggl
丂	skk
伨	ewsi
偛	ewrj
恦	yrni
囕	lsqm
趥	dugo
蝢	kdmb
彄	vgll
帤	clmv
岉	jwto
渿	ifhs
瑵	gbok
鈖	wtbd
訷	ukea
麛	ivar
渳	ivar
湵	iuyo
嬇	clkm
捖	aofh
狧	rreq
欪	xxei
趦	dsel
諌	ufjr
欯	hlei
鶱	ostr
蠁	vqok
墿	hmhd
覂	dqpe
悎	ywlv
鄒	wxwc
籯	qumb
芿	sevj
駊	dvpm
偤	eugo
晵	iejr
睗	mjwt
躟	nosr
籹	pcnm
岆	jeos
緟	bwkk
浛	itol
馻	dvqr
黰	ndmt
畧	jelv
湶	iekv
馺	dvod
绬	vskg
鎒	wsac
徖	rohs
瀌	iiuo
葠	sexb
鎞	wrwr
亜	alfi
醓	gyqm
蛷	kfko
愗	cqey
厑	slri
鑗	wrwk
縵	bjmb
嚊	ltja
砐	dvod
侻	eulq
呝	livi
囬	msiw
冞	ypmm
憏	ywhs
脷	wrmd
砓	dqhh
鷴	kfro
茪	smhw
獘	umts
楌	fiqt
撆	umtt
曏	jvqc
艖	qufo
焼	udsh
灃	ijdu
悋	yplv
臿	wrjk
拕	aori
嬏	cqpj
螿	xwak
嘙	livc
峅	jvsj
惸	ywjv
暭	jesd
縩	bwhs
毢	rdxm
鮋	tkoy
昲	jvti
傟	etvx
伀	etvv
聬	atvx
臎	wxxd
龞	umtj
槴	filc
瘈	pdbg
衼	pdbu
鎭	wrmt
悪	alfy
儣	eust
鍈	wskg
黫	ndht
暁	jdsh
餛	yjrr
曘	jdsr
菋	slhe
銭	wsgg
腝	wsgd
浂	iugd
鈸	wsbo
楪	fhfv
塤	hlmb
臙	wsfu
滝	iikd
浉	iufm
氊	ronf
詋	ulqr
隮	cous
禒	hbds
媂	coum
焒	ullv
轗	gdfy
軲	gdgc
佊	evpe
篐	qfgm
畒	ojte
繣	bxhf
畽	jwkk
麞	iijd
譤	ueoe
鏌	wsjg
獀	rrnb
榡	fhbs
孲	vfja
躆	nmds
曤	jdwi
颿	drfm
搼	augt
枺	fhov
濓	iiqt
俤	euvq
镸	haaa
鴇	rdro
鈄	wsdi
絑	bwti
跿	ndkv
褌	pygc
蒪	sfac
槸	fhto
楘	cqef
扏	ayfo
捬	auea
賎	msgg
襏	pbvq
躀	nbdm
橏	fuul
壣	havx
櫿	fuul
孊	cpli
襐	pyld
黿	fhjm
唜	hlri
滫	ienw
猄	roma
篖	quxl
岶	jebs
嫆	cptl
甀	wsfa
妏	cpwn
圷	hakt
鳰	rrou
惿	yjfn
嫐	cjxc
韰	mrbf
浵	iwot
枠	fydi
墪	oveh
噒	lpra
鎡	wuvv
鳧	rqjo
籂	qyqm
軂	wuux
摾	avlk
彃	vjsa
媱	cewo
蔰	silc
嬀	ceww
鐥	wuul
嚤	lptu
螜	hfkc
濳	iwqj
柕	fcqp
漝	ixxe
攺	cehk
亴	ohyf
謮	uhmb
槰	fedp
膁	wuxt
蔳	sihw
櫍	feem
猭	rbds
庒	uhod
梫	fxyb
譖	ugqj
蔁	sijd
墝	hhhh
婂	cemv
嬡	ceye
箚	qymd
渀	igds
臇	wwkf
蘜	sgwp
樤	fenf
樇	fenw
宯	ohvk
萿	sire
浺	iyln
熰	ugll
嚟	lrwk
撳	awei
狿	rqnx
摋	awfq
唙	lruo
猤	rbfg
龏	iwms
鄐	ovjc
鬰	fwwt
娪	cfcl
膉	wutm
憣	yqpj
砱	dtob
鍂	wwjj
娬	cfgn
戻	igde
婖	cfgo
枛	fekv
龔	iwmt
濢	ixxd
垼	rqht
杹	feri
蕼	shxa
蚻	fxkc
婻	cdkd
巋	jynm
錍	wwdi
枿	fdsj
峞	jysv
飵	yqmo
払	avvo
娔	cdqr
搎	avqb
畳	jymi
厫	shwe
胇	wvti
跒	nalv
耟	dtgb
矂	mllf
牶	ugwn
檟	fdmb
鐖	wvvt
嫮	cdfs
漚	igll
朸	fxkv
棶	fdlv
欞	fdlt
鉋	wwck
懎	yhtl
喩	lrfv
橚	fxtf
呏	lqsj
禰	hftw
麏	ixql
聨	avvs
瓵	vlaw
焏	vlbu
歒	ouke
吺	lqhv
呹	lqgu
拫	avno
槥	fddx
顋	jydm
啇	oukd
塐	hhbs
踄	nnma
峗	jysv
糓	hfpm
鎻	wvmb
媃	ccqf
簛	qdej
欛	fdgw
氹	vkvi
篲	qddx
扱	avod
釨	wvkj
泇	ixlv
揟	avnw
樳	fxfa
漌	igsi
乸	cbmy
嶕	jwuo
饇	ygll
萐	sfxn
旕	otsr
脗	wwtl
隌	cijr
斸	bkme
牑	tinc
徦	rbsb
蟤	kcct
脪	wwsm
阸	civi
嚺	lmup
恊	yxxx
笅	qwwl
餧	yrcn
杗	ufvw
洷	ihks
鬔	hedp
賟	mkst
颴	rqvn
棷	fabu
鱾	qbjy
悷	yisq
塅	hefq
揨	aoan
鈆	wtvv
泑	ivxk
劚	bkmm
侖	tfnc
贍	mysu
洠	ivwn
硲	dttl
乻	otsv
繟	blld
鯻	tflm
嘑	lmqa
梀	fflv
噳	lmlg
趞	dsjr
岊	cjsb
屶	jbds
湢	iflj
泿	ivns
篟	qehw
飁	xxer
嶎	jbha
噮	lmfr
鯟	tfjr
訹	ufod
孈	cjwl
曶	wtjr
佮	eyee
嶣	jwuo
揃	auwm
謖	ujte
熚	ujsa
儳	eylo
敯	cajb
囘	kckf
婸	cjft
蹨	nwsu
婐	cjfv
腍	wtoy
膥	hdvt
耛	dtvl
肣	wtov
鵲	sjro
鵆	rrah
鍧	wwua
蝚	kcqf
乵	oxix
笩	qegy
擄	amjx
檉	falg
舥	qcbo
楃	fbhk
罋	ovqw
砈	dsvi
蘙	sgqx
檘	fblo
汘	iwks
擕	awkf
揰	awkk
廘	uilu
蓡	sixb
蜛	kbdg
幐	wugm
洔	ihac
鄟	gacj
洈	iysv
籗	qdwi
槜	fwvj
綗	bktl
欝	fwwa
勄	qbxk
峱	rbjs
椵	fbsb
冘	yqrm
蕍	sitm
礱	iwmd
妱	cblv
籊	qxxw
蓱	sius
啘	lorv
浳	igwy
竱	igac
婍	cgal
慏	yyjt
浫	iyth
蘁	sgll
蓲	sgll
礪	dssk
韔	chai
扚	awod
渒	iwdi
蟇	sjgk
櫄	fwne
陼	chjr
蚭	kbri
嚸	lnml
趖	dtth
袌	owcr
鱆	tijd
顦	wudm
鲪	qxql
鷍	tfro
鎂	wugd
蔂	sjbs
悏	ygtt
繷	bkss
嫟	cgsl
嬺	cgsy
揁	ammb
禠	hemu
翤	lnxx
惲	yygc
簈	qbqh
挅	avfv
緐	qbqb
鶂	rqro
欑	fwqm
乑	etsi
銉	wxao
瑫	gerj
揻	adfc
瀀	idwe
嗊	lfmb
朳	ftiv
鈊	wyij
阧	csdi
訿	unri
騅	dwim
珆	gvlv
訒	ubod
凴	sdqj
銃	wovq
攐	aosr
膰	wqpj
筺	qggo
洦	idjr
竆	pwll
峘	jfjf
饏	vaey
薡	smxt
挩	atlq
伌	esvi
峺	jfjw
贑	ijfm
翶	essx
阾	ctob
鞁	gvpe
叿	lfov
迀	hpdg
瑔	gekv
氫	qfvf
崋	jfsd
踲	nedm
稬	rsgd
褄	pdxc
萲	sehb
閹	kgkd
矒	msmm
熅	untm
嘕	lfnu
靷	gvns
賳	mdgl
鸝	fkfr
絸	bmxs
睵	mdgl
攓	aosn
溹	idyb
擑	alag
騣	dwxe
卂	vdii
璅	gvjf
鏑	woud
霢	dwer
箺	qgjr
窛	pfhc
蔩	soft
跧	ntgn
氁	rsjg
彨	fkkt
讜	unne
梩	fkkv
釳	wqvi
檜	ftfj
脺	wotd
頪	pdmb
鋐	wosv
樐	fklv
梌	ftff
筪	qgkj
燂	udjd
呩	lhsv
鍗	woum
釚	wyfj
叏	bnbu
荗	sdod
椙	fjjr
姅	cuao
櫑	fjjj
岏	jfhw
艌	qtoy
槑	lflf
呄	vdgj
煝	ubmf
鎿	wytu
曺	fkjr
慁	ndyi
鎊	wouo
陊	crrk
憿	yeoe
阰	crri
窴	pdmt
姈	ctob
栥	sefv
萗	sohs
昁	jfmv
飴	yvlv
琻	gwjn
蛺	kgtt
惤	yvov
爎	uogm
捈	atff
陙	csnj
専	fkac
弅	tbsj
瓧	adiw
嚡	lghh
慀	yevg
墑	houd
鞿	gvvt
敤	jfmb
豙	idsd
櫋	ftpo
乕	esmv
煷	uoqj
懧	yoya
傮	esjj
褑	pehb
廀	uoub
硾	dwsf
靤	gwck
唓	lgcv
譠	uonf
揇	adkd
摵	adkm
縌	buxp
豴	doud
靎	dwro
詉	ucbu
揼	adkv
忣	yvod
埦	horv
煛	mmuo
偄	esgd
懓	yeye
繉	bmqs
鞱	gerj
樖	yfal
槯	fjwi
渃	issl
瓰	atbd
鏼	wqfk
鉨	wyma
礳	dpdh
洃	isuo
繓	bjab
撊	akwy
羋	snao
幜	mjom
鍑	wqje
羜	uoan
兺	tblr
鞽	gell
鴺	gvro
韝	cskh
譲	uotr
偢	eruo
茩	sefl
炞	uoak
匫	gwtj
厳	isve
揥	aoum
灠	isqm
匢	gwto
峛	jfrm
埞	hofn
廃	ubsq
鐌	wyld
洏	isrs
驤	dosr
墎	hovc
躓	neem
傇	esar
脕	wylq
靮	gwod
柗	ftlv
梲	ftlq
躻	wpfo
厰	sneh
灢	idlr
艅	qtff
隃	ctfm
皍	erxj
袙	peby
鰥	tmkv
鏨	gewj
酈	fkfc
虁	sdme
敪	bbbe
瀦	idhj
聄	atto
眪	mfkt
銛	wrej
戞	dwyg
啂	levx
齰	msjr
溨	idgf
幤	nemv
轚	gxqg
坄	hqht
罊	gxqw
皡	eesd
昛	jgbu
炄	ubco
鱤	tdfy
笁	qfok
暷	jgac
柦	fjfi
朞	dwyj
顚	rmxm
鈰	womv
齼	mffn
嬟	cuqg
珶	guvq
鵕	vter
犿	roak
浲	iedn
骪	mqod
坔	khtv
炐	udno
焢	upfo
戉	gxig
粸	pdjm
韹	ijeg
髾	hmwy
窉	pfkt
袹	pdjr
鞖	gecn
愯	ywbu
鸜	mmwr
嬜	ijec
琒	gedn
娧	culq
樏	fjbs
嚽	lhwm
籝	qucn
蛯	khri
扡	acyo
狊	msqf
蚲	khue
嬚	cuut
闥	khup
槳	xwaf
蓧	senf
蜙	kftv
鑙	wrdj
佡	etjs
嬹	crkt
勹	wyyy
銫	wycb
灡	isku
鏇	woqn
旣	ergq
狦	rnfi
嶴	rpgj
稩	rjwy
臖	rkfw
躌	nqsa
秵	rngd
忂	rmmw
舓	rjwt
狏	rqcy
郳	rqcj
颵	rmwy
覒	rmxm
秞	rkoh
稇	rnfv
遚	rnbp
鄋	rnbc
悡	rmyi
蹸	npra
鋫	rmwj
毸	rjyi
糴	rpxw
姕	nrcn
歮	nnni
毇	rpqh
毩	rpmm
忁	rjxk
穃	rptl
鷆	rmxr
獜	rpra
狪	rkfl
稒	rndg
稤	roma
狆	rlns
獹	rmjm
秺	roqa
凣	nqjs
鬮	nqjm
踇	nqbm
玀	rmbw
惒	rlyi
猔	rohs
躋	nous
獱	rofm
穦	rofm
鷻	rove
穙	rkug
獤	rove
獛	rkug
穧	rous
歬	nqoi
猠	rkst
勶	rovx
饻	rory
鴕	rori
忀	rosr
穣	rotr
毴	rlim
猅	rliq
狛	rebq
徆	rdxc
秹	reen
鷌	rdmo
徝	rdmi
獁	rdmq
憄	rdmy
顩	rdmb
頢	rdmb
獿	rdme
狵	rdto
諬	rdua
衚	rdwa
獶	rdwe
獖	rdsm
穤	rdsr
圙	ntgi
囶	ntht
悤	reyi
稏	rfja
鬬	ntbe
穱	rema
鴼	relv
穚	rell
狅	renq
鷈	remu
跉	ntob
獢	rell
踗	ntoy
趻	ntov
朙	ntkw
獥	reoe
獔	resd
鴤	resi
鼳	rbms
徲	rbkw
猳	rbsb
秜	rbri
稺	rbox
颾	rbok
劔	rbod
鼧	rbor
鼦	rbbl
鼺	rbjj
劎	rbdl
鬫	nvae
顈	rbdm
鼥	rbso
秓	rdbu
圁	nuaw
駂	rddm
躕	nuda
犩	rcww
秠	rdfi
徱	rdhs
稘	rdjh
猉	rdjq
嵆	rdjs
秙	rdgh
鼪	rbwg
讏	rclu
躛	rcln
瓾	rcaw
讆	rcau
躗	rcan
徫	rcic
颹	rcif
稦	rcih
邜	rcjk
鄥	rcjo
稨	rinc
踿	nruo
穮	riuo
猀	rimq
鈭	nrwj
稖	rilv
跢	nrrk
馟	rjev
穝	rjab
猏	riwy
徿	riwm
馜	rjbr
獓	rhwe
穡	rhtl
狫	rhri
蹛	nsfm
狋	rhsq
躤	nsdj
頥	nsdm
鬦	nsdi
鴲	rjro
猑	rjrr
馫	rjrj
馪	rjom
馦	rjut
馛	rjso
穓	rjst
屳	rjsu
馚	rjtb
馠	rjtl
蹝	nrnn
馣	rjgk
馢	rjgg
狚	rjfi
獌	rjmb
啙	nrll
歶	nrky
馤	rjjx
馧	rjjm
秿	rfuh
鰴	rfty
穪	rftw
獮	rftw
狇	rfvq
龸	nsss
囲	nsti
颲	rfrm
徛	rgal
衐	rgba
蹃	nssl
獺	rflm
稫	rflj
稉	rfjw
犻	rfmv
徰	rfnn
徚	rfnu
頴	rhdm
秲	rhac
穯	rhll
徺	rhhh
穘	rhhh
獟	rhhh
颫	rguf
飉	rgum
藄	sdbs
蔧	sddx
躒	nevf
蒢	sctf
薽	sdha
凐	sdht
蔈	sdhs
藸	sdhj
蘟	scey
趶	nfau
蕷	scdm
媐	sccn
葌	sccc
圑	nfac
蓩	scqx
鶜	scqr
藬	sclm
巸	sckc
乧	sdvi
荿	sdvi
歄	neia
蘎	sdwc
苩	sebj
葮	sefq
茊	sefi
茠	sefv
薍	sebx
莑	sedn
蕆	sdmb
蒖	sdmt
厧	sdmt
蘦	sdll
蕶	sdtb
慿	sdsy
蓫	sdpd
虂	sdnl
蓵	safn
蘵	saij
荴	sagu
萔	sabl
躎	nftw
菗	sako
葀	sare
蘀	samd
莏	samq
歫	ngbu
鬭	ngbe
猽	ryjt
秴	ryeh
欭	ngei
穐	ryjk
鶳	ryfm
舚	rysu
踕	nfxn
犱	ryod
芆	sbod
葿	sbmf
荵	sboy
臤	sbuc
掔	sbtu
蓪	sbtp
孯	sbvk
鋻	sbwj
蕟	sbvq
苨	sbri
荱	sbrm
蒓	sbax
蒃	sbds
硻	sbdh
葤	sbac
菢	sawc
藧	sbeb
藯	sbhy
鬪	nfla
蘰	sbjb
蜸	sbkc
蘕	sbep
葒	sbfo
葟	segn
藮	sfwu
慸	sfyy
萙	sfyq
毻	sfwr
遀	sfwp
葝	sfvx
菶	sgao
菚	sggg
蓒	sghg
莗	sgcj
厙	sgch
蓜	sgbj
芖	sgdj
薚	sfrt
茢	sfrm
炗	sfuo
薞	sfry
萰	sfnu
蒆	sfqc
茾	sfsj
囙	nbuw
芌	sfsk
囻	ncai
蕐	sfta
萶	sgjr
茥	shht
荎	shkj
厈	shgh
芉	shgj
賾	shmb
蔶	shmb
薘	shup
蓻	shuo
蕔	shub
蘾	shor
茙	sgso
萇	shaj
芅	sgyj
蘻	sgxb
乲	sevi
蒵	sevg
芢	sesi
蒊	serr
蓞	serj
踎	ndlv
贋	sewm
蘨	sewb
踸	ndxi
苮	sejs
葲	sekv
藵	selr
茽	seln
敐	sehn
攷	sehk
跭	neao
菦	sepd
薂	seoe
秶	serh
厵	semm
蒚	sfln
囏	sfll
虉	sflr
鷰	sflr
嬊	sflc
酀	sflc
臡	sflt
劌	ndfm
顪	ndfm
厯	sffs
藲	sfgl
蓛	sfke
莄	sfjw
莍	sfko
莿	sfkm
蹮	ndgc
荰	sfht
躚	ndgp
荁	sfjf
徣	rsjr
稓	rsjr
蹪	nlkm
圚	nlkm
轝	rskg
玂	rsle
獡	rrwu
卶	rrxj
斘	rsdi
颰	rsbo
翗	rrxx
秡	rsbo
穁	rsar
毺	rtfm
徻	rtfj
獪	rtfj
稐	rtfn
秂	rteh
秎	rtbd
蹕	njsa
氌	rtjr
穭	rtjr
鸌	rswb
躢	nkjx
秐	rsvv
舃	rsuo
狣	rqss
秳	rreh
圐	nmog
郺	rrvc
稪	rqje
歨	nnfi
穞	rqjr
鳬	rqjo
龝	rqjm
踃	nmwy
踻	nnav
鶃	rrqr
飍	rrrf
舙	rrre
粊	rrpm
穒	rroh
鴰	rroe
穥	rrst
毞	rrrm
枈	rrfv
秝	rrhh
夡	rrhl
黸	nmjm
勓	rrex
獫	rrlq
犳	rwod
毥	rwjr
猚	rwiq
秊	rwkh
秊	rwkh
鯬	rwqt
剓	rwqb
睝	rwqm
穳	rwqm
徟	rwhl
跮	nhkv
穇	rvvt
稄	rvte
秛	rvph
匘	rvrw
颮	rwck
猈	rwdi
夝	rwgk
徃	rwgc
穕	rwfv
狕	rvxk
踷	nhjr
跇	nhiv
鳨	rxko
鵦	rxkv
顖	rwym
恖	rwyi
爴	ngle
穊	rxvq
穛	rwuo
蹖	ngrj
燢	rwwu
鱟	rwwt
猣	rwxe
雤	rwww
觷	rwwt
嶨	rwwj
黖	ngqr
旤	ngqr
斆	rwwe
嚳	rwwl
秚	ruao
徾	ruai
獙	rume
蝵	rukc
稥	rujr
衑	rtoa
獊	rtol
毝	rtom
熧	rttu
獋	rtsd
斞	rtsd
夗	rvik
毶	rvgt
䅟	rvgt
踍	nhvk
頺	rvdm
圔	nhvm
衟	rvda
妴	rvcn
獼	rvfw
彶	rvod
稰	rvnw
秮	rvlv
踜	nhte
颷	ruuo
鶖	ruro
蹗	nilv
獇	ruxv
悐	ruyi
鍫	ruwj
稵	ruvv
踥	nicn
刉	qvmd
窔	potw
袉	pori
瘯	poqq
粇	poqj
宔	oogn
斏	povn
裗	povq
癛	ponr
痯	pobb
痐	pnlv
痎	poib
谉	ooke
糘	pods
髚	ooqj
癤	pqxx
裄	prah
斴	prae
甐	praa
癪	prhm
亃	prax
癙	prbu
籷	pqai
褣	pptl
袕	ppxy
襎	pqpj
袟	pqgu
籶	pqjm
斔	pkrt
糛	pnht
衻	pksi
痶	pkst
袡	pkht
粴	pkkm
螡	pkkc
螤	pkjt
瘻	pldc
頏	oqdm
粡	pkfl
窤	pjrr
襮	pjsk
癳	pjjb
裮	pjjr
裃	pkak
蚉	pkcw
畨	pjtm
痬	pjwt
宂	oqjb
粆	pmqp
窧	pmjd
宩	opmb
癭	pmmc
袩	pmlv
旈	oovq
癦	pnht
裍	pnfv
襡	pmwk
瘑	pnab
斍	pmxw
衶	plns
䙡	plkm
䙌	plkk
糫	pmfr
癏	pmfr
辬	opox
斖	prkm
糋	puwm
籸	pvdi
斈	pvkw
寠	oldc
宺	olaq
梥	pvfv
宲	olfv
瘬	pvha
疓	pvjb
亪	pvii
褨	pufo
裷	pugv
瘜	ptyi
裫	ptxf
衳	ptvv
褝	pujd
痥	pulq
裞	pulq
袀	pwsi
粅	pwto
袾	pwti
襸	pwqm
袧	pwlv
粷	pwpm
裑	pwmy
粁	pwkm
糭	pwxe
襑	pxfa
袯	pxbo
癄	pwuo
痭	pwwy
裪	pwwo
瘹	pwwo
粣	pwwf
痸	pwkm
糝	pvvt
氷	okvd
袎	pvxk
褈	pwkk
瘇	pwkk
窓	pvyi
窇	pwck
﨎	pwbu
裏	okry
襍	pwfv
粺	pwdi
襔	psfr
瘔	psdg
襽	psku
糷	psku
襺	pskk
糎	pskk
褠	pskh
襼	pshv
褿	psjj
鵉	proi
鴪	prox
痜	prqj
襝	prly
鶁	omro
瘲	prtn
袳	prrk
襷	prst
竁	prrr
蹵	omdn
糩	ptfj
襣	ptja
䦷	ptth
疭	ptte
彣	ptow
剤	ptsm
賌	ombi
糲	pssk
粠	psti
袻	psry
粀	psod
癧	psrn
衯	ptbd
痻	ptaj
疧	ptai
疷	ptao
糚	psxh
糤	pswe
寍	oymn
黀	pabu
襵	paaa
疛	pacb
寱	oxtf
寣	oxua
塱	oxvh
欴	oxve
郒	oxvc
褎	otfr
褏	otfr
勆	oxvx
剆	oxvm
襃	otfr
痆	pbri
疦	pbte
糔	pbok
騫	ostd
粎	pbod
籾	pbod
糏	pbmw
宑	osti
寋	ostv
窷	patm
疜	pakb
瘺	pbdy
窡	pbbb
褬	pbbf
褖	pbds
粈	pbcm
鐜	ovew
撉	ovet
郎	ovcj
旀	ovma
袬	ovlr
叜	oubu
齍	ounm
覫	ouym
鶙	ouyr
斺	otti
旔	oxax
寎	oxft
頝	otwm
虠	otwm
䴔	otwy
逳	ovwp
糣	pgqj
褳	pgpd
旞	oqup
瘞	pgth
瘽	pgsi
裺	pgkd
褗	pgjc
糆	pgim
窢	pglf
痮	phab
旍	oqtb
瘱	pgty
鵼	pfro
椉	oraf
疘	pfob
竀	pfnm
疞	pfsk
襧	pftw
穼	pfvx
糡	pijq
麊	pilm
糄	pinc
疨	phyb
覾	oqpm
窏	pifa
粐	piem
斒	pinc
襊	pjab
糃	pjft
瘍	pjft
襱	piwm
斾	oqmv
褤	phlr
痓	phkb
寙	oqqu
襀	phmb
旟	oqrt
襓	phhh
膐	oqrt
衦	phgy
褋	phfv
竈	phjm
竃	phjk
袣	phiy
疶	phib
鴧	oqro
窙	phvk
痚	phvk
斻	oqqj
裋	pflu
黂	pdsm
瘨	pdmt
惌	orvy
袶	peao
袲	orrr
痝	pdto
糂	pdxi
瘎	pdxi
䜩	osfu
籵	pdim
粨	pdjr
褼	pdgc
稁	orhl
衧	pfau
穻	pfau
瘷	pfle
襋	pfkk
瘶	pfle
襹	pfki
襰	pflm
瘂	pfja
宐	orfi
寲	orqn
鶮	orol
迱	orpd
鴋	orog
宒	ormb
粰	pevk
窱	penf
穾	peox
窹	pxfl
凢	qqjp
艞	qqqs
舧	qqqo
髛	obyf
鳤	qqob
矪	qqoi
飜	qpjb
勫	qpjx
乀	oddd
鄦	qsfc
橆	qsff
艜	qsfm
悹	obby
箻	qrxa
籢	qreh
笟	qquk
鎜	qqwj
筕	qrah
笓	qrri
篽	qrqx
篵	qrtn
籅	qrst
籎	qrqn
賔	obmb
鵃	qroo
釈	qpbo
笽	qmnk
篎	qmmq
笝	qnbu
凧	qmvj
矲	qmvr
欰	qmei
衉	qmel
歊	oeil
䜣	oeja
籮	qmbw
筫	qmbk
衃	qmdu
刏	qmdq
艣	qmjx
籰	qmmb
簤	qmmb
笘	qmlv
笡	qmik
笐	qoqj
籏	qoqd
箷	qoqc
鶷	odlr
艈	qovq
艆	qovn
筤	qovn
箊	qots
簺	qosh
艩	qous
艕	qouo
篣	qouo
簻	qnpd
艡	qnjt
簬	qnel
筃	qngd
箮	qoff
笇	qoak
鲿	qnsv
笉	qwsi
瓝	qwod
跀	nwyv
艐	qwxe
躦	nwqm
笧	qwwf
簲	qwwd
笣	qwck
篗	qwbu
箄	qwdi
籪	qvve
箽	qwkk
箰	qwjv
圕	nxhj
艁	qwlv
籛	qwgg
簓	qwht
篒	qysk
艬	qylo
𧾷	nvvv
忥	qyiq
笂	qyod
躖	nvvn
篧	qywi
鴚	ralv
鴴	raro
囼	nvlv
圎	nvmb
飅	ragj
狾	raej
踓	nwiv
笖	qxot
蠞	qxvk
歱	nwkk
竻	qxkk
囜	nvvw
鳛	qxxe
笜	qxxg
蹘	nxxt
笷	qtmk
艪	qtjr
筨	qtol
亣	oajd
筡	qtff
䲟	qtfx
踭	nyxv
乯	quav
籩	qtpp
舼	qsti
鴵	qssr
艧	qswb
籆	qswb
凨	qsvv
跲	nyev
鳒	quxt
凲	quxt
笰	qvti
笲	qvsj
黕	nyqr
䲡	qugo
箞	qugv
辪	nyox
乊	quep
黭	nysj
乥	quvi
簩	quux
艔	qusb
艤	quqg
寈	ohwy
凮	qdjr
箂	qdlk
瓥	qdkk
箶	qdwy
籱	qdww
氥	qdxq
艝	qdxl
筙	qdti
簊	qdht
簨	qcct
筎	qclv
郍	qcjo
箹	qbwo
箳	qbus
啎	qdfl
旘	oigj
籖	qdgf
篻	qdhs
籈	qdha
寴	oifm
竾	qcyk
簯	qfdj
箖	qffv
氭	qfjr
籭	qfki
凬	qfjr
氞	qfkt
寚	ogwo
笎	qfhw
寭	ogyi
氬	qfja
箯	qefw
筿	qefv
鲘	qefl
舽	qeao
艂	qedn
鶎	ohro
筟	qevk
艀	qevk
笗	qesi
簥	qell
筗	qeln
艊	qemv
鲬	qbtn
畗	ojtl
粭	pyem
畆	ojvv
瘒	pygc
䦶	pyxv
衴	pyqr
疩	pydi
粶	pxkv
瀪	qbek
鳚	qbha
艠	qbfu
寷	ojdu
慜	qbey
鰵	qbet
箼	qbhk
篃	qbmf
髜	ojqs
籜	qamd
箉	qalx
鲄	qalv
笴	qalv
箃	qabu
亯	ojrl
簎	qasj
亰	ojma
鵇	qaro
籡	qarl
鵍	ofhr
鳁	qjmn
鳂	qjgf
屲	qjsp
箟	qjrr
篊	qist
簅	qiqw
篭	qikd
簄	qilc
戭	ofkg
氱	qjft
箈	qivl
笵	qivi
箲	qiwq
簣	qlkm
宱	oeqm
簞	qlld
鼅	qljm
艛	qldc
衈	qmar
愙	oely
宎	oeob
籔	qlde
𥫗	qkkk
簢	qkpw
寪	oeww
𠂉	qkkk
氠	qkeq
笚	qkjk
聟	qlar
箿	qlar
艥	qlag
艒	qksm
笍	qkte
氝	qkte
篞	qijh
舿	qgfs
簵	qgel
簐	qgei
歓	qfwe
勧	qfwx
篿	qgac
舦	qgod
䲠	qgjr
殶	ogqh
欫	qfne
鲾	qflj
篢	qfmb
簭	qftl
遾	qftp
凩	qfvj
籋	qftw
迬	ogpd
篫	qfqt
篕	qhvm
顁	ofnm
艢	qhtl
鲓	qhsk
顮	ofmm
笌	qhyk
筂	qicy
舮	qieo
寁	ofxn
箌	qhmd
籉	qhlh
篈	qhha
筀	qhht
犅	wkuj
鐗	wkwy
鍓	wlar
鍝	wkyj
憅	wkxy
罁	wkuj
鏷	wkug
鑆	wkua
軆	wksu
鐰	wllf
鑓	wlkp
躳	wllv
鍔	wlls
鋛	wlln
脵	wlfg
欨	wlei
敂	wleh
頶	wldm
軁	wldc
鐀	wlkm
鍻	wjwx
鑴	wjwl
鍶	wjyi
鎉	wjxx
鍟	wjwg
鍴	wjsr
錌	wjsh
鏀	wklj
鍆	wknj
膶	wkgn
鉠	wkgd
鑭	wkfu
鉮	wkej
鋰	wkkj
錔	wkjr
犤	wmvr
鑺	wmmw
鏬	wmqa
釙	wmoj
鏜	wnht
膕	wngf
𠂒	wnnn
钂	wnne
鏛	wnmv
鑜	wnmb
銦	wngd
鐤	wmxt
鋧	wmxj
鏴	wnel
鐬	wndm
勂	wlxk
鋇	wmbj
釥	wmaj
銱	wlmv
胑	wlti
鴝	wlro
鈙	wmbu
鑪	wmjm
鋽	wmjd
胋	wmlv
鐪	wmjx
臄	wmds
釗	wmdj
鑡	wmcj
钀	wmfs
鎠	wmfn
鉬	wmfj
鏎	wjsa
鋏	wgtt
匎	wgkd
躽	wgjc
錼	wghs
鍷	wghh
鉕	wglv
鑎	wglm
鑩	wgll
膒	wgll
鏂	wgll
鍱	whfv
膮	whhh
朑	whiy
鉪	whij
鋣	whcj
鐐	wgum
鏯	wgww
躼	wham
釴	wgyj
鏸	wgyi
錷	wgxi
鑈	wftw
釫	wfsk
錰	wfuo
牼	wfvf
鉦	wfni
鉽	wgfo
鏩	wgej
牫	wggn
鐟	wggj
躸	wgal
鑻	wfwt
釱	wgdj
鎽	wjed
鉭	wjfi
銂	wiqc
䥇	wixx
脳	wiwx
犥	wiuo
銟	wjmv
鎾	wjmn
鎤	wjmh
鐛	wjom
迿	wjpd
錕	wjrr
鈤	wjrj
鍡	wjgf
腲	wjgf
躶	wjfv
錁	wjfv
錩	wjjr
鑘	wjjj
釒	wjjj
鑸	wjjh
鍽	winc
錂	whte
脿	whry
銠	whri
胓	whue
﨨	whud
圱	whtk
釷	whtj
鎱	whlr
郮	whlc
胵	whky
鑟	whmm
鎺	whmi
鐽	whup
軇	whva
膱	wigj
鍅	wihv
軄	wigj
鏱	wijd
錇	wilv
犝	wikk
鐿	wijy
腤	wijr
鎑	whvm
﨧	whvk
釾	whyj
鋕	whyi
鐹	wnpd
朠	wskg
臈	wsjx
鏪	wsjj
瓻	wsma
鑶	wsgs
鐷	wshf
鐯	wshj
鑮	wsia
鑉	wshm
肰	wsqy
胹	wsry
鍩	wssl
鑖	wsmo
鋠	wsnj
錺	wsog
銌	wsnv
鍣	wsbl
懖	wryi
釞	wruj
鑦	wsbm
犐	wrsd
鉹	wrrk
臔	wsbm
鏵	wsfd
軅	wsew
鏋	wsfr
錵	wser
鑝	wsep
頯	wsdm
膌	wssw
鎦	wtjt
鑥	wtjr
鼄	wtjm
鉩	wtma
腀	wtfn
膾	wtfj
肹	wtsk
鋊	wttl
甮	wttn
谸	wttl
釤	wtoj
鈐	wtov
錜	wtoy
鈜	wsvv
鈪	wsvi
郩	wswc
銰	wswl
鏾	wswe
鐝	wsue
躮	wtbd
肦	wtbd
銽	wtal
勽	wtey
銪	wswy
匒	wsye
鎝	wsye
鉸	wotw
腣	woum
犜	wove
鐓	wove
膟	wovd
鑇	wous
錊	wotd
鋃	wovn
鉈	wori
鈧	woqj
牨	woqj
鍦	woqc
鴅	woro
鑧	woso
臗	woso
鑳	wosn
鎄	wory
銥	wory
鋺	worv
躴	wovn
銤	wpmj
鏲	wovw
錥	wovw
鋶	wovq
鉉	wovo
鑏	woya
鎵	wods
鎋	wodl
銨	wocn
鍹	woff
鏥	woej
鑌	wofm
牭	wnqr
膃	wntm
鋜	wnvj
罉	wntu
鍄	woma
牥	wogn
軉	wogm
鈁	wogj
腟	wohk
錝	wohs
酇	wqwc
牬	wqxq
鈲	wquj
錗	wrcn
鏭	wqpy
罀	wqss
銚	wqss
躷	wrcn
鏫	wrmf
鋓	wrmd
敮	wrmb
鐱	wrlj
匇	wrky
鵢	wrom
鵭	wroj
銄	wrnj
鎪	wrnb
釸	wrkj
匂	wriy
犔	wqpm
鎎	wqpm
鉇	wqcy
鋨	wqag
鑹	wprb
鈫	wpwj
鈼	wqmo
釩	wqod
脠	wqnx
鈠	wqhj
胅	wqgu
膓	wqjt
釠	wqjj
鉃	wqij
巤	vnwb
辸	vpdj
﨤	vopd
弴	vovk
婱	vovc
辝	vlox
刣	vlmd
叾	vlvl
弲	vlwy
謽	vlku
𤴔	vnii
貟	vmbv
孭	vmbk
孾	vmmc
厼	vmav
乨	vlxi
彏	vmmb
彋	vmfr
弤	vtao
彉	vskt
鴘	vsro
鶸	vsvr
鄪	vtmc
逘	vqpd
愻	vqby
矤	vqig
鄕	vqec
弬	vscg
弫	vscg
弖	vfig
弞	veig
弳	vfvf
瓕	vfto
弡	vgbu
孠	vflv
煭	vfru
弝	vcbg
夃	vbuj
鳵	vdro
戼	vgfb
乪	vjti
疀	vjfn
顄	vkxm
脀	vkfw
䌷	vkos
弽	vhfv
軬	vggc
奙	vgkd
貵	vgmb
⺄	viii
𠃌	viii
㔾	viii
乛	viii
脴	wdlv
顀	wdmb
顉	wdmb
鎷	wdmj
犆	wdmi
脜	wdmf
錸	wdlj
銆	wdjr
錤	wdjj
鐔	wdjd
鉐	wdhj
鐳	wdjt
鏚	wdkm
鈈	wduj
肧	wduy
銇	wdti
鎍	wdyb
膤	wdxl
鍸	wdwy
鑐	wdsr
鐼	wdsm
鵯	wdro
鋴	wdqr
肗	wcny
鍒	wcqf
腬	wcqf
釲	wckj
銣	wclv
蜰	wckc
鍲	wcaj
鈀	wcbj
錒	wcal
鈱	wcai
鐉	wcct
鐊	wcjt
鍏	wcij
鉟	wdfi
鈷	wdgj
鐁	wdej
鍥	wdbg
釶	wcyj
鬾	wdbu
鈘	wdbu
銔	wddi
鋍	wdyv
躰	wffi
鉢	wffi
銩	wevv
鋢	wevk
燞	weuo
鎐	wewo
鋌	wexn
鎘	wfln
鍢	wflj
腷	wflj
鈵	wfkt
閷	wfkt
脼	wfmr
脨	wflv
脙	wfko
鈨	wfhw
錏	wfja
錻	wfgn
腖	wfjr
銝	wefv
鋲	weft
腶	wefq
銗	wefl
鍰	wehb
胮	weao
銋	ween
鉜	weac
鋝	weac
鈑	webu
鍁	weei
膖	wedp
鍎	wedm
鋖	wecn
缼	weio
鈋	weri
鐈	well
犞	well
釽	wekj
肵	wejy
鏅	wenw
鎀	went
鈓	wenj
遪	vvvp
叅	vvvo
剼	vvvm
毿	vvvr
厽	vvvv
厸	vvvv
亝	vvvs
孴	vvvj
螚	vwrk
熋	vwru
皰	vwck
彅	vuwb
孡	vvlv
纼	vvns
弜	vvgg
鏆	wbdm
鍨	wbfg
腞	wbds
釖	wbdj
鐙	wbfu
鐑	wbhl
鈻	wbbu
鎟	wbbf
腏	wbbb
腵	wbsb
鍜	wbsb
犌	wbsb
鈮	wbri
銿	wbtn
鋦	wbvl
叐	wbuk
鐴	wblo
鉧	wbmj
鎇	wbmf
躵	wboy
鈬	wbod
釰	wbod
肞	wbod
鉺	warj
孧	vxvk
彇	vxtf
釮	waqp
劺	vwxk
孻	vxfm
鐂	wagj
牱	walv
鈳	walv
鎶	wall
鋷	wabu
孞	vyik
吢	ylvi
叴	ylvf
悞	ylxg
饠	ymbw
敆	ymbu
酁	ylrc
𠂊	ymmm
憈	ymkg
蠫	ymkk
懁	ymfr
愲	ymgi
懌	ymhd
飷	ymis
冝	ymim
烉	yktu
餇	ykfl
貚	ylld
憒	ylkm
愪	ylmb
貗	yldc
慺	yldc
勨	yldx
粂	yopm
餏	yory
愃	yoff
飳	yogn
怺	yokv
饝	ypdh
懡	ypqv
愱	ypqi
戂	ypli
悙	yovl
龡	ynei
饖	yndm
饄	ynht
憆	ynht
慖	yngf
饓	ynfv
鼏	ymxt
悓	ymxi
飰	yoak
龣	ynxk
㣺	yodi
戃	ynne
恛	ynlv
怬	ynqr
餖	yflu
餷	yfjf
怲	yfkt
餞	yggg
慪	ygll
惐	yglf
餣	ygkd
悑	yfui
餴	ygds
顐	ygdm
鄆	ygcj
愋	yehb
餭	yegn
餱	yebq
貃	yebk
餁	yeen
惞	yeei
冧	yffv
悿	yfgo
忨	yfhw
冟	yeri
貕	yevg
餺	yfac
愮	yewo
忲	ygod
惈	yjfv
饂	yjmn
憴	yjmi
惼	yinc
悩	yiwx
鄍	yjoc
畣	yjte
蛗	ykcd
愢	yjyi
鼆	yjoj
懪	yjsk
饆	yjsa
惃	yjrr
憢	yhhh
豻	yhgk
忓	yhgi
怽	yhei
餦	yhas
恄	yhlv
懛	yhlh
恎	yhki
怈	yhii
憓	ygyi
悈	ygsj
饉	ygsi
鶤	ygro
怴	ygxi
懄	ygsx
慡	ygww
皸	ygvp
慞	yijd
餢	yilv
麁	yilm
饁	yhvm
慠	yhwe
貖	yutm
怑	yuao
懩	yugv
亇	yvim
貇	yvnk
憦	yuux
餤	yuuo
餹	yuxl
觬	ytrq
鵤	ytro
觪	ytox
餩	ytoi
觮	ytxk
觲	ytuw
觾	ytsu
觵	ytst
搻	yttu
飻	ytto
愶	yxxw
飿	yxxg
貀	yxxg
憳	yxfa
忇	yxki
惂	yyrj
怭	yyqp
橤	yyyf
繠	yyyb
忰	yydi
餫	yygc
饞	yylo
愌	yykg
貄	yxao
怉	ywck
懏	ywkf
惍	ywji
隺	ywim
餕	yvte
怶	yvpi
厹	yvvf
愡	ywty
㥮	ywxx
豿	ywlv
怐	ywlv
餙	ywsm
饡	ywqm
豼	yrri
恀	yrrk
懙	yrst
餰	yria
憁	yrey
鴭	yrod
愼	yrmt
饚	yshm
厃	yshm
冩	yrwu
飹	ytms
憡	yqfk
怢	yqgu
貁	ypxk
愹	yptl
飥	yqai
瓭	yqaw
憮	yqsu
餆	yqss
鴓	yqro
沊	yqkv
貈	yqok
忛	yqod
覕	yqmx
愺	ysjd
饃	ysjg
悇	ytff
觻	ytef
觩	ytfo
惀	ytfn
觨	ytfk
懀	ytfj
怟	ytao
觶	ytld
恮	ytgn
觛	ytjf
㓁	ytim
觰	ythj
甔	ysta
飠	ysss
懨	ysjs
貛	yslw
餝	ysog
恠	ysnh
懱	ysmo
饊	yswe
忶	ysvv
餀	yswl
忯	ytai
憽	yswy
鋟	wxyb
脇	wxxx
鉿	wyej
鍕	wygc
肍	wyfy
勼	wyfy
匌	wyey
鑃	wxxw
匓	wxvq
鈯	wxxg
忎	wyik
鈂	wyqr
鉍	wyqp
鑱	wylo
鋔	wylq
釻	wyod
肒	wyod
鑁	wwxe
鍐	wwxe
甧	wwwy
朤	wwww
犓	wwxx
胷	wwxw
鋾	wwwo
鎸	wwvj
匑	wwvg
雦	wwwi
雥	wwwi
雧	wwwf
銏	wwwf
鉯	wxot
釛	wxkj
鉫	wxlv
牞	wxkn
鐞	wxfa
釓	wxij
夨	xgdi
丩	xggg
丱	xggg
彠	xflb
銺	xhwj
焋	xhuo
娤	xhcn
牃	xhfv
衋	xadm
⺻	xfil
妛	xfcn
鷦	wuro
鉳	wuri
犪	wute
鈥	wuoj
缹	wuoo
邎	wuqp
灳	wuoy
鎰	wutm
錓	wuxi
鎕	wuxl
膅	wuxl
躿	wuxk
釯	wuwj
犫	wuww
鎆	wuwm
鏞	wuxw
魐	wuxt
讎	wuwi
腅	wuuo
錟	wuuo
鑅	wuuf
甶	wuuu
鉱	wuvv
鐒	wuux
鐎	wwuo
鉡	wuao
鎓	wtvx
鎴	wtyi
匃	wtxi
錈	wugv
犈	wugv
䲢	wugq
鎹	wugp
羘	wugy
鐠	wukj
鏳	wujj
鎈	wufo
軈	wuey
躾	wugd
膡	wugm
爒	wugm
賸	wugm
鋯	wwlv
匔	wwll
鑂	wwne
臐	wwne
銵	wwmj
釺	wwkj
鈝	wwnj
鉎	wwgj
鏶	wwfv
鐫	wwkf
鎩	wwfq
錭	wwhl
銁	wwjr
牪	wwnn
肳	wwto
憌	wwsy
鍯	wwty
鍃	wwty
肑	wwod
銑	wwqr
鍤	wwrj
釕	wvlj
鈶	wvlv
鏹	wvlk
鈟	wvns
鈏	wvns
犣	wvnb
鍿	wvfj
錙	wvjt
釢	wvjj
釔	wvij
魕	wvvt
鏒	wvvt
犙	wvvt
褜	wwcr
鎨	wwdi
鈗	wvqr
膷	wvqc
鈹	wvpj
鐨	wvtm
鉘	wvti
鋑	wvte
芔	xxxg
姭	xxxc
翑	xxwl
冣	yabu
辥	xyox
飣	yans
忊	yani
翞	xxom
糶	xxpw
鷚	xxtr
剹	xxtm
雡	xxtw
鄝	xxtc
翵	xxro
翐	xxqg
翇	xxso
憛	ydjd
頧	ydmb
頄	ydmb
憘	ydlv
饢	ydlr
懳	yddy
怌	ydfi
顊	yddm
饙	ydsm
餑	ydyv
懥	ydyn
貑	ybsb
餯	ybds
憜	ycsw
怓	ycbu
饌	ycct
彞	xpbs
夛	xrkl
鵘	xqlr
裠	xqlr
帬	xqlm
乫	xlvi
嗧	xltn
毠	xlrm
帇	xmvl
翄	xxdb
翨	xxjn
劜	xxik
翋	xxid
翴	xxgp
歗	xtxe
牄	xtol
槩	xvgf
墏	xwah
鱀	xvgt
堲	xvxh
蘂	syyf
氒	tadi
鯫	tabu
葪	sytm
莭	sxvx
鸏	syfr
菷	sxym
蘬	synm
蘥	sync
凕	syjt
蒏	sygo
鹲	syfy
藑	syke
薶	sykk
鮖	tdhy
鰾	tdhs
鱏	tdjd
鯐	tdky
鯕	tdjy
鱩	tdjt
鰔	tdfl
鱊	tcql
魾	tdfi
鰇	tcqf
鰄	tdfc
鯎	tdvi
鯸	tebq
鮒	teac
鱈	tdxl
澃	tdmk
嬃	tdmc
鯠	tdly
鱚	tdlv
鱝	tdsm
鱁	tdpd
鰢	tdmy
魢	tbjy
鮉	tblv
牊	tblv
鮿	taxi
魨	taxg
鱍	tbvq
炃	tbuo
郋	tcjk
鯒	tbtn
鰠	tbok
鰕	tbsb
苐	svnq
苰	svvv
孶	svvv
苝	suri
蓙	suth
菧	suto
蓔	suuo
苂	suoj
憠	suxy
葞	svar
萾	svbm
葥	suwm
薕	suut
蓎	suxl
橜	suxf
蕂	swux
荕	swxk
葼	swxe
萠	swwy
莃	swsm
菙	swsf
厜	swsf
艻	sxkj
蔇	sxvq
蔒	sxqu
荍	sxeh
茟	sxao
蕁	sxfa
朢	swgn
戫	swgf
菳	swjj
凎	swji
龓	swim
雈	swij
蒛	swbt
蔱	swfq
﨟	swjx
厒	swoh
蘍	swnx
葄	swqm
蟼	swlk
苅	swmd
魬	tebu
鮊	teby
敓	tlqe
尒	tmae
鰐	tlls
鱢	tllf
鯡	tliy
魦	tmqp
鯱	tmuy
䦆	tmmb
鱰	tmhj
鱡	tmgs
鱞	tmfr
魝	tmdy
鱋	tmkg
鰛	tjmn
鰻	tjmb
仚	tjse
鯧	tjjr
鼼	tjax
鯷	tjfn
鱪	tjhj
鰑	tjft
魻	tkjy
魶	tkte
鯣	tjwt
鰓	tjyi
鰨	tjxx
鮦	tkfl
鮫	totw
鯲	tots
鰟	touo
鱭	tous
欦	tove
敜	tove
鰝	toly
魧	toqj
毈	tooq
辠	toxk
戧	toxg
酓	tovg
鯙	tovk
鯍	tovq
雂	tovw
侌	tovv
鰘	tohk
頿	tnrm
魴	togy
鱥	tndm
鯝	tndg
丯	tnso
鴒	tobr
鯇	tofh
鰚	toff
鰮	tntm
鯄	tfko
鱺	tfki
魭	tfhw
鄶	tfjc
朇	tfjd
臰	tfrr
魳	tfmv
鰊	tfnu
厁	tffx
鰷	tenf
鯦	teml
鮥	telv
鰁	tekv
臮	tett
鮲	tesq
鱳	tevf
鮜	tefl
鮾	tecn
鮴	tefv
鰀	tehb
鮘	tegy
嵞	tffj
雓	tffw
鱫	teye
牔	tfac
鰩	tewo
甈	tfaw
侴	tfbm
魱	tfbm
鯃	tfcl
魲	tiey
鯜	ticn
鯿	tinc
鯋	timq
䥺	thyj
鮃	thue
鯪	thte
鮳	thsk
鯖	thwy
鰪	thvm
齇	tjam
齈	tjas
齅	tjas
齂	tjak
䦂	tixx
齀	tjaa
鼿	tjah
鮱	thri
鰋	tgjc
鯂	tgoy
鰆	tgjr
鮬	tgfs
鮔	tgbu
鱙	thhh
鰈	thfv
鮇	they
鯺	thjr
鰿	thmb
鮚	thlv
舗	thlf
鰰	thke
𠔉	tgui
鰳	tgxk
鮧	tgvg
莌	sulq
蒷	slmb
飌	sllr
贒	slnm
鸛	sllr
蘄	slle
蕇	slld
鄿	sllc
酄	sllc
顴	sllm
虈	slll
蓶	slwi
荶	sltv
藈	smbg
蕜	slyi
萞	sktr
黆	sktq
黇	sktl
黅	sktv
蕽	skss
黊	skth
黈	sktg
茣	slfg
厛	slej
蔞	sldc
蕢	slkm
菵	skuu
薱	skua
蕄	skyi
勱	skxk
凙	smhd
蘃	snnf
荹	snma
薗	snhr
薉	sndm
蔮	sngf
莡	snvj
蔨	snuv
荌	socn
蒕	sntm
莔	sntk
苬	snte
蔝	smpm
萈	smod
薒	smrp
萀	smuj
蘮	smsm
萛	smsj
蔖	smmi
萴	smmd
蕒	smmb
薎	smyg
顭	smym
藣	smvr
芇	smvj
萷	smwm
鄸	smyc
蘉	smyb
莇	smxk
莧	smxj
莦	smwy
虃	sitf
蒤	sitf
薀	sinm
蓅	sioq
薃	siol
蔢	sivc
莐	siyq
蒅	siyf
厬	sjel
蘴	sjdu
菭	sivl
薻	sivf
萢	siwc
薓	sixb
菺	siwy
菬	sibl
羐	shyo
藙	sidq
薸	sidh
苉	shxi
蔜	shwe
蔋	sikb
萻	sijr
薼	siht
藽	sifm
蔆	sihe
菃	sigb
蔅	skcn
虄	skew
茰	sjwl
厴	sjwk
凗	sjwi
莮	sjxk
懕	sjwy
荝	skmd
茮	skma
蔄	sklv
蓾	sklj
鶧	skgr
覯	skhm
顜	skhm
荲	skkj
蠆	skkc
龷	sjjj
蕌	sjjj
卝	sjjj
蘲	sjjh
蘽	sjjf
嬮	sjwc
凒	sjfu
剒	sjmd
鶓	sjro
葃	sjqm
逪	sjpd
藶	ssrn
荋	ssrj
蠚	sslk
莀	ssnj
逽	sslp
刱	stbt
葐	stbm
茋	stao
燛	ssuo
苃	ssbu
菣	ssbu
冹	ssbo
藖	ssbm
蒝	ssem
蕮	srwu
菞	srwq
蕵	srys
萟	sryo
蘒	sryk
蘳	sskh
蘣	sskg
蓤	sshe
臩	ssgt
蓌	stte
莝	stth
遳	sttp
菤	sugv
蓭	sugk
蔊	sujh
葁	sucn
虊	subf
冸	suao
蒫	sufo
蕿	sueb
輂	stgc
坓	stht
菕	stfn
蕦	stdm
莟	stol
汬	stkv
蛬	stkc
蒥	stjt
苚	stnj
蒾	sppd
蘱	spsm
藱	spwu
蓢	soxw
藌	soyk
蔤	soyj
薴	soya
厗	soxh
蓈	soxc
厏	sqmo
萭	sqlk
芁	sqjj
厇	sqai
苵	sqgu
蘺	spxw
䓖	spxk
凉	solm
𠂇	soo
萓	somi
藃	soei
藼	sody
荢	sofa
藔	sogm
薧	sofr
薲	sofm
蔲	sofe
蔏	soul
蔐	soud
藡	soup
茡	sovk
蓘	sotr
蔉	sotr
蔙	soqn
苀	soqj
萒	sotq
藆	sost
蘈	srqm
蘒	srqj
蘌	srqh
蒈	srre
磿	srrd
蓹	srqx
蒩	srmi
萂	srlv
薟	srlj
鴯	sror
蔦	sroj
鳫	sroh
蕱	srmw
蕛	sruq
蕕	srug
蘓	srty
蓯	srtn
藇	srst
萪	srsd
蘔	srrm
茤	srrk
凞	sqsu
苸	squa
莥	srbc
鍳	sqwj
譼	sqmu
擥	sqmt
芞	sqqj
蒰	sqqh
蘏	srhm
藊	srin
葕	sria
蕏	srhj
薐	srhe
芕	srkj
虋	srkb
蘝	srei
蘞	sreh
茒	srcj
譕	uqsu
烑	uqss
庣	uqss
庅	uqvv
鲝	uqyg
譗	uqye
炿	uqwo
烐	uqoo
巟	uqrw
灮	uqro
烅	uqmn
譣	urla
羷	urlg
秌	urho
廎	urdm
廭	urhm
煈	urfo
丠	urfi
羫	upfo
詸	upma
詃	uovo
誏	uovn
羪	uovn
譈	uove
焪	upvg
炈	uqho
謏	urnb
煗	usgd
讛	ushv
庻	usft
剫	usfm
鷓	usfr
廗	usfm
誫	usna
爦	usqm
爁	usqm
爡	uskk
鄺	uskc
諎	usjr
庴	usjr
灷	usjo
燤	usky
煍	uruo
鄁	urwc
熪	urrr
鴹	urog
烥	usco
剙	usbt
炦	usbo
剏	usbo
炓	usdi
誮	user
謜	usem
諮	usel
詙	usbo
訲	ulns
熉	ulmb
諤	ulls
炾	ulqr
熡	uldc
廔	uldc
讝	ulle
燀	ulld
讉	ulkp
燡	umhd
譃	umkg
爈	umjy
吂	ulvw
灲	umdo
讕	ukfu
詇	ukgd
庘	ukju
炠	ukjo
朚	ujwy
焬	ujwt
讗	ujwl
焵	ukuj
爜	ukub
焹	ukuu
諿	ular
庽	ukyu
燗	ukwy
譋	ukwy
焨	uksw
詗	uklv
爞	ukkk
燶	ukss
譨	ukss
譹	uods
諪	uoan
焲	uoeo
燺	uofv
諚	uofn
羦	uofh
訵	unqr
烗	uoio
爙	uosr
庡	uory
焥	uorv
炨	uori
謪	uoul
謫	uoud
烄	uotw
熍	uoll
燷	uonh
讅	uoqj
燣	uonr
嫳	umtc
爣	unne
謯	ummi
爘	umry
炶	umlv
詀	umlv
訬	umqp
謼	umqa
鐅	umtw
煾	ungy
焑	unfv
爅	unht
譡	unjt
訨	unia
誚	umwy
諣	unaa
誢	umxa
諥	uwkk
訋	uwod
爋	uwnx
烿	uwot
蠯	uwdk
螷	uwdk
焷	uwdi
焳	uwio
訤	uwwl
焩	uwwy
廫	uwxt
訩	uwxg
諈	uwsf
詵	uwqr
諊	uwpm
誵	uwsw
褮	uuyr
詪	uvna
鎣	uuyw
謍	uuyu
熒	uuyu
憥	uuyy
爉	uvnb
鶿	uvvr
甆	uvva
炥	uvti
羛	uvti
謲	uvvt
訠	uvns
訯	uvod
訙	uyod
焔	uynj
讑	uync
譫	uysu
訦	uyqr
熐	uyjt
応	uyiu
悥	uyia
訅	uyfa
讂	uyke
彁	vall
丮	vaoi
熓	uywo
熻	uyxx
烚	uyeo
甉	uxna
鄌	uxlc
鶼	uxnr
屰	uxge
欮	uxei
詜	uxbu
劷	uxkg
熮	uxxt
炪	uxxg
詘	uxxg
誛	uxyb
賡	uxtm
鶊	uxtr
鷛	uxwr
羗	uxvv
炩	utob
鷁	utmr
焾	utoy
諗	utoy
訡	utov
庈	utov
謒	utol
噵	utpl
詯	utka
庺	utvf
焀	uttl
焧	utvy
鮺	utyg
詤	utxq
庎	utti
炌	utti
烡	usti
讈	usrn
爏	usrn
訜	utbd
諙	utaj
廥	utfj
燴	utfj
庩	utff
庂	uteu
詴	uswy
燪	uswy
烠	uswy
爑	uswu
烵	uswo
艵	usyc
羴	uuug
譧	uuut
熫	uusu
庰	uusj
爃	uuuf
譱	uuua
煢	uuyd
醟	uuyg
檾	uuyf
甇	uuya
𤇾	uuym
滎	uuyk
謭	uuwb
焍	uuvq
熑	uuxt
劆	uuxm
譾	uuwx
烪	uugd
譐	uuga
烾	uuht
煪	uugo
詊	uuao
譢	uudp
顃	uudm
諩	uukg
燨	uuqg
鶑	uuro
炏	uuoo
顲	uuom
歚	uule
敾	uule
敥	uumb
鮄	tvti
鰯	tvss
毤	tvqr
鰺	tvvt
鶲	tvxr
鯴	tvqk
勜	tvxx
鮐	tvlv
鯔	tvjt
鱜	tvqc
鮍	tvpy
魥	tvod
鯌	twlv
鯯	twkm
魡	twod
鹟	tvxy
鮑	twck
鮏	twgy
乮	tvim
牉	tuao
鱃	tubc
鱶	tugv
鰌	tugo
鱒	tuga
鰦	tuvv
鮷	tuvq
龵	tuuu
鱅	tuxw
鯵	tvgt
枀	tvfv
鮵	tulq
鱛	tujj
䦅	tuul
鮩	tusj
頖	uadm
廰	uady
鵥	uamr
炣	ualv
鮅	tyqp
鮠	tysv
訁	uaaa
讘	uaaa
灓	ubbk
欒	ubbf
卛	ubbd
䜌	ubbs
孌	ubbc
諁	ubbb
庉	uaxg
鯼	twxe
臫	txik
亾	txie
鱘	txfa
鮢	twti
魩	twto
鯑	twsm
鄎	tycj
鯞	txym
鮼	txyb
鮙	txxi
鱂	txwa
鱌	tyld
仺	txle
劧	txku
鱐	txtf
鮶	txql
鵨	trro
魮	trri
魞	truy
鯚	trvk
鯏	trmd
魹	trmy
鷠	troy
舘	trob
鰹	tsbh
鮁	tsbo
鰽	tsjj
鄓	tscj
鰖	tsfw
鯀	tqbs
鱵	tqdl
鰒	tqje
臱	tpog
鰫	tptl
魰	tpwy
鮡	tqss
鯅	tqnx
鮓	tqmo
鱕	tqpj
逧	ttlp
豅	ttlm
豄	ttlm
谼	ttlt
鵒	ttlr
谻	ttla
螸	ttlk
魸	ttpy
魪	ttti
睂	ttnm
鯰	ttoy
鷱	tssr
鰙	tssl
鱱	tssk
佱	tsni
鱴	tsmo
鱹	tslw
臯	tssd
鯩	ttfn
鱠	ttfj
夎	tthe
鱯	tswb
孿	ubbv
帣	ugmv
謰	ugpd
齤	ugmc
廤	uglr
觠	ugyt
詽	uhhg
羠	ugvg
絭	ugbs
詎	ugbu
勬	ugbx
駦	ugdm
炑	ufvo
烴	ufvf
庯	ufuu
烳	ufuo
爩	ufwt
諽	ugea
讍	ugll
譇	ughj
謳	ugll
烒	ugfo
煂	ugeo
譛	uggj
⺶	uggg
𦍌	uggg
諓	uggg
譊	uhhh
諹	ujft
詚	ujfi
謾	ujmb
譝	ujma
誯	ujjr
熴	ujjr
熶	ujab
謆	uixx
爖	uiwm
羻	uive
燳	ujbu
熀	ujmh
謃	ujwg
朆	ujut
焺	ujqs
爗	ujsd
熼	ujst
煓	ujsr
諘	uhry
熆	uhvm
廅	uhvm
誟	uhvk
庨	uhvk
燽	uhva
譸	uhva
燵	uhup
誈	uhka
詿	uhht
庢	uhku
詓	uhvv
燑	uikk
譩	uijy
燱	uijy
熩	uilc
詶	uiqc
諞	uinc
謸	uhwe
庌	uhyu
誺	udla
諵	udkd
諆	udja
譆	udlv
謤	udhs
燍	udej
譿	uddy
煘	udfl
謣	udfs
驘	udmw
煁	udxi
奨	ueag
詂	ueac
炋	uduo
燯	udtb
羺	udsr
烼	udso
燌	udsm
訍	ubod
譅	ubon
謘	ubox
灱	ubdo
爥	ubkk
廜	ubhj
煣	ucqf
讔	ucey
緳	udbb
煀	ubxx
諃	uffv
煿	ufac
烶	uexn
炢	ufod
訌	ufoa
烞	ufmo
訮	ufsj
齹	ufmc
諨	uflj
譌	ueww
諼	uehb
炇	ueho
烌	uefv
諻	uegn
詻	uelv
燆	uell
庍	ueju
炍	uebu
詬	uefl
熢	uedp
謑	uevg
烰	uevk
譍	uewu
熎	uewo
謡	uewo
燩	ueoe
謕	uemu
廏	uerq
謟	uerj
炛	ueri
訛	ueri
倽	etre
仱	etov
侳	etth
僋	etom
仈	etie
僔	euga
倊	etvy
傠	euac
僙	eskt
傋	eskh
偀	eskg
侟	esnv
儚	esmr
皣	esfd
儰	esew
傆	esem
傼	esfg
僀	esfm
僃	eswt
佄	essi
儮	esrn
侕	esre
儖	esqm
倠	ewie
偅	ewkk
仢	ewod
噕	ewlv
佨	ewck
鄬	ewcj
俷	ewcb
僟	evvt
頲	exdm
㑳	ewxx
倗	ewwy
劤	exkj
劰	exkb
俙	ewsm
爳	ewvl
伆	ewto
傏	euxl
嗠	evel
偝	eurw
儝	euuf
偂	euwm
僗	euux
僐	euul
偦	evnw
伄	evns
儠	evnb
跾	enen
焂	eneu
鎥	enew
鋚	enew
俕	eofv
俒	eofh
譥	eoeu
偨	enrf
儫	eods
僘	eneh
傦	emge
儢	emjy
仦	emae
歋	emei
偼	emxn
俔	emxe
䴘	emya
儏	emrp
偗	emqm
俿	emue
墍	ergh
佸	eree
俰	erlv
佲	erlv
傱	ertn
伖	esbu
傁	ernb
覛	ermx
鴁	eroo
俼	eovw
偯	eory
倇	eorv
儕	eous
俲	eotx
侎	epme
倁	eqlv
侜	eqoe
伩	epwe
皒	eqag
槫	fgac
棾	ffyq
蝅	fgfk
槬	fgfq
翉	ffxx
櫕	fggm
貮	fgmb
鵡	fgnr
鴌	fgro
迗	fgpd
梄	fgov
櫮	fgll
椻	fgjc
昋	fgjr
奣	fgjw
榃	ffjt
梂	ffko
欐	ffki
栜	ffkf
栵	ffrm
檷	fftw
辳	ffsn
枅	ffsj
椘	ffpe
梪	fflu
楋	fflm
楅	fflj
杢	ffov
柾	ffni
梇	fgsj
櫦	five
﨔	fitt
栦	fiqc
櫳	fiwm
樶	fjab
樴	figj
椖	fiog
枦	fiev
樚	filv
樈	fijq
槾	fjmb
刯	fjfm
棏	fjfa
欙	fjjb
琧	fjgo
椳	fjgf
皶	fjfv
榿	fjfu
坖	fhht
橈	fhhh
棖	fhav
梜	fgtt
樲	fgsm
桋	fgvg
枎	fguv
兘	fhvl
橽	fhup
梽	fhyi
樍	fhmb
椡	fhmd
榬	fhlr
榸	fhkk
榰	fhrj
樌	fbdm
欚	fbdk
朷	fbdv
楑	fbfg
檰	fbem
枾	fati
栮	farv
櫞	fbbd
瓨	fawo
橻	fbbb
棳	fbbb
杶	faxg
欘	fbkk
梞	fbyi
樼	fbvv
橃	fbvq
樄	fcfj
杒	fbod
栂	fbmv
柖	fblv
榌	fbkv
梕	fboy
榐	fbsg
伜	eydi
欇	faaa
㑇	eyxl
橊	fagj
桺	fagb
偩	eymb
伔	eyqj
倹	eyte
栰	fegg
檼	fefy
椞	fefv
梹	feft
梔	fefc
椺	felf
楾	fekv
蜤	fekc
樰	fdxl
櫌	fdwe
梍	feai
桵	fecn
栙	feao
樷	ffab
惁	feyi
橓	feya
榣	fewo
櫾	fewb
梺	ffak
桏	ffcj
杅	ffau
梻	fevt
榽	fevg
枖	feov
櫟	fevf
榹	femu
橷	feuq
檪	fesf
槹	fesd
槄	ferj
梎	feri
櫀	fdbs
櫘	fddy
楆	fdcn
忢	fcyi
楲	fdfc
櫏	fdgp
椷	fdfl
櫲	fcyd
逜	fclp
樮	fduo
橭	fdox
橒	fdsv
檽	fdsr
橨	fdsm
橶	fdjg
榪	fdmv
樭	fdht
檦	fdhm
橲	fdlv
欜	fdlr
皷	dvpd
雭	dvod
碯	dvrw
矷	dvkh
駘	dvlv
甤	dwgs
霌	dwhl
騆	dwhl
駨	dwjr
趛	dwjk
碒	dwjh
霛	dvvv
驂	dvvt
礒	duqg
磸	dugg
驣	dugd
礢	dugv
驓	dujj
尮	dvfv
礯	duub
磱	duux
磰	duul
砿	duvv
騚	duwm
尲	duxt
磏	duxt
磀	duxp
夦	dxrr
尠	dxmq
趢	dxkv
勑	dxkl
赲	dxkk
霥	dyfd
硆	dyeh
磖	dxxe
愸	dxyi
尰	dwkk
駯	dwti
赹	dwsi
鸖	dwro
靍	dwro
鶘	dwro
趭	dwuo
騘	dwty
靃	dwwi
豞	dwlv
砃	dwob
馰	dwod
礸	dwqm
趲	dwqm
趜	dwpm
硉	dxao
鶈	dxcr
鄾	dwyc
騶	dwxx
礷	dssm
硔	dsti
翸	dsmx
礣	dsmo
歕	dsme
礰	dsrn
礛	dsqm
猌	dsql
磭	dswy
霕	dsvx
靀	dsyd
靅	dsvm
霴	dsvk
霒	dsvv
霼	dsvp
卋	dsfi
枽	dsff
驊	dsfd
硴	dser
桒	dsfv
驠	dsfu
騵	dsem
礥	dsbm
﨣	dsdi
顬	dsdm
趪	dskt
碤	dskg
礶	dslw
礍	dsjx
尭	dshw
馵	dsjm
騲	dsjd
砎	dtti
赺	dtov
砛	dtov
耯	dtsb
騇	dtre
耲	dtor
諅	duaj
賫	dttm
駗	dtto
耣	dttn
耚	dtvp
騟	dtfm
硢	dtff
硂	dtgn
駩	dtgn
砏	dtbd
趆	dtao
耓	dtan
碈	dtaj
赿	dtai
頛	dtdm
耫	dthm
䎱	dtmr
耡	dtmx
䎬	dtmv
駠	dtmm
耝	dtmi
砽	dtnh
駖	dtob
蟚	dtkc
騮	dtjt
傄	egum
侇	egvg
偧	egrr
帒	egmv
傴	egll
仼	egne
僆	egpd
僡	egyi
侤	ehsk
皌	ehob
坕	ehtk
偞	ehfv
佅	ehee
鶢	ehbr
仠	ehge
儓	ehlh
偖	ehjr
侀	efsm
鵂	efro
倯	eftv
劶	eflx
侸	eflu
仜	efoe
傿	efnu
僌	egeh
侙	egfo
垈	eght
儧	eggm
俴	eggg
柋	egfv
恷	efyi
伣	ekxe
僂	eldc
賲	elfm
敋	eleh
爫	ekkk
仩	ekse
傊	elmb
諐	elqu
偔	ells
僓	elkm
敿	elke
侱	elgn
儙	elkp
僺	ellf
勪	elkx
洜	elkv
儱	eiwm
偐	eiqt
偣	eijr
傹	eijq
傽	eijd
灥	ekek
儶	ejwl
儑	ejvu
侺	ejtv
敒	ekeh
傝	ejxx
邍	ejxp
僈	ejmb
𠂆	ejjj
皔	ejhg
儤	ejsk
倱	ejrr
鄇	ebqc
伬	ebod
鵎	ecro
侞	eclv
僛	edei
偠	edcn
偰	edbg
馾	dyqr
愂	dyvy
鵓	dyvr
駜	dyqp
倳	ealx
姇	eacn
頱	eadm
皧	eeye
僢	eeya
賃	eemb
啠	eelv
俻	eejt
斦	eejj
劕	eemm
傂	eemu
仾	efbm
儷	efki
侢	efkh
倲	efjr
俹	efja
倵	efgn
仹	edne
佦	edhe
儎	edgg
頎	edmb
俖	edlv
傶	edkm
僨	edsm
俽	eeei
儨	eeem
皨	eeeh
皛	eeeb
栠	eefv
俀	eecn
佭	eeao
玒	gfon
匞	gfof
輌	gfkj
瓎	gflm
夶	ggdd
邼	ggcj
奆	ggbu
瑼	ggac
轁	gerj
蹔	genv
軠	genc
覱	gemx
醂	gffv
璴	gffn
匸	gfff
珸	gfcl
弌	gfiy
酛	gfhw
酻	gevk
琈	gevk
轢	gevf
瓅	gevf
琽	ghjr
玴	ghin
鞢	ghfv
鞊	ghlv
匭	ggyf
璤	ggyi
瑇	ghbm
瓄	ghmm
輤	ghwy
珯	ghri
醻	ghva
玶	ghue
輘	ghte
圶	ghtd
酜	gguo
鄻	gggc
醆	gggg
戔	gggg
轑	ggum
轃	ggrh
轋	ggpd
珡	ggte
匧	ggtt
匲	ggll
輏	ggoc
軖	ggnc
虦	ggmu
瑻	gbdm
靵	gbce
軘	gaxg
珁	gawn
靫	gbod
醗	gbsq
璏	gbrr
瑂	gbmf
軺	gblv
玿	gblv
榋	fxxx
桘	fydv
栬	fycb
栛	fxxx
楎	fygc
朹	fyfv
杺	fyiv
桾	fxql
疌	fxnf
楖	fxvx
櫭	fxvf
瑘	gacj
輙	gabu
甎	gaaw
璢	gagj
酠	galv
梚	fylq
榠	fyjt
榓	fyqm
棦	fyxv
椧	fyxj
棎	fytf
検	fyte
瓇	gdwe
轌	gdxl
轜	gdsr
逩	gdsp
槧	gefv
瑖	gefq
輴	gedm
磛	gedh
瓍	gcsp
瑈	gcqf
邞	gcju
轊	gddx
巪	gbvi
乬	gbvi
叀	gccc
瑉	gcaj
頊	gdmb
琜	gdln
輱	gdfl
珬	gdfi
醥	gdhs
韆	gdgp
瓋	goup
釄	gpli
醾	gppm
轔	gpra
迋	gpdn
璌	goft
琔	gofn
璸	gofm
琓	gofh
輐	gofh
鞝	gnse
玣	goak
珿	gnvn
輬	goma
迏	gopd
奒	goid
輆	goic
軴	gogn
鞂	grhe
軞	grmc
醶	grlo
匳	grlf
悘	gqyi
璵	grst
瓈	grwk
軤	gqua
朁	gqgj
珟	gqfr
輧	gqhh
軗	gqhc
珴	gqag
繋	gqbs
玝	gqdi
玔	gqcn
嫛	gqqc
軓	gqod
匴	gqms
軮	gkgd
醠	gkgm
瓗	gjwl
韅	gjvu
琾	gjtt
輵	gjwx
鞐	gkak
奛	gjwy
輞	gkuu
鞻	gldc
剦	gkmd
琡	gkmb
靹	gkte
軜	gkte
琠	gkst
輠	gjfv
輰	gjft
瑅	gjfn
鞛	gilv
軶	givi
奫	gitf
韀	gisu
輥	gjrr
鞸	gjsa
軕	gjsc
輲	gjsr
轠	gjjj
瓔	gmmc
匷	gmmw
醳	gmhd
槼	gmfv
轤	gmjm
靻	gmie
輄	gmhw
奯	gndm
珚	gngd
鞇	gngd
輎	gmwy
鞩	gmwm
匰	glld
甌	glla
鞼	glkm
靧	glkm
剾	gllm
釅	glle
輫	glic
戜	glgn
軙	gmbu
珼	gmbn
夵	gmad
嫢	gmcn
琄	glwy
軹	glti
毄	glqh
鶫	fnur
榲	fntm
欓	fnne
柶	fnqr
鴊	fnro
棞	fnrh
橴	fnrb
檹	foql
鶐	fopr
檁	fonr
櫰	fomr
椬	fomi
橠	forr
棜	fots
欀	fosr
棭	foeo
楁	foel
樎	foej
櫶	fody
檺	fods
槣	fogl
堏	foht
榁	fohk
榩	fmpw
椇	fmti
鳾	fmro
櫖	fmjy
櫨	fmjm
檌	fmli
楨	fmmb
欋	fmmw
樝	fmmi
栶	fngd
椢	fngo
槶	fngf
檲	fnga
靕	fnhw
杫	fniv
慐	fmyi
䴓	fmya
檙	fmxt
頙	fndm
檅	fndm
楇	fnav
樀	foud
聓	fqoa
樦	fqog
杋	fqod
柉	fqpe
櫡	fqhj
巬	fqgu
椥	fqlv
権	fqfw
楀	fqlk
櫷	fqjm
椱	fqje
桝	frao
榤	fraf
枡	fqsj
橅	fqsu
櫤	fqum
柧	fquv
橁	fqwj
杚	fqvi
椌	fpfo
辷	fpdi
桹	fovn
橀	fovm
櫅	fous
楴	foum
棛	fovw
橣	foyt
櫁	foyk
樒	foyj
怸	foyi
怷	foyi
檱	fqdj
杊	fqcv
杔	fqai
槉	fpqi
柼	fpxv
桞	frcj
慦	fkoy
皳	fkov
栧	fkqp
椣	fkst
檂	fkss
欁	fksf
椚	fknv
櫩	fkyr
橌	fkwy
㭎	fkwl
櫢	flde
棢	fkuu
檏	fkut
欈	fjwl
郠	fjwc
楒	fjyi
鵶	fjro
鶇	fjro
楐	fjtt
梤	fjtb
杣	fjsv
柍	fkgd
橍	fkgn
彲	fkft
橺	fkjr
螙	fkkc
櫊	fkel
邐	fkfp
桛	fkak
婯	fkfc
剅	flum
豏	flut
毭	flur
豍	flud
郖	fluc
欏	fmbw
梖	fmbv
檈	fmfr
梋	flwy
遬	flep
鬸	flkj
慗	fley
疈	fljj
棑	fliv
揧	flmt
槵	flly
鷊	flkr
梙	flln
楍	flll
欕	flle
樿	flld
櫠	fubq
橂	fugg
栚	fugd
椨	fuea
榳	fuex
杽	ftuv
鵐	fttr
覡	fttm
棩	ftxf
棇	ftvy
枩	ftvv
橩	fuuq
檆	fuul
樜	fusu
檤	futp
榏	futm
橯	fuux
槏	fuxt
椩	fuxt
榶	fuxl
杧	fuwv
椾	fuwm
櫎	fust
櫧	fuhj
椦	fugx
桰	ftal
椕	ftbf
櫹	fsxf
檴	fswb
烎	fsuo
橵	fswe
櫒	fswh
檧	fswy
栯	fswy
櫵	fswu
槆	fswj
櫯	ftrh
棯	ftoy
枔	ftov
梒	ftol
橰	ftsd
枍	ftsk
桽	ftth
櫼	fttf
桼	ftkv
櫓	ftjr
橮	ftmb
璽	ftmo
蠒	ftmk
壐	ftmh
桸	fwsm
橪	fwsu
欎	fwwa
檭	fwvn
橳	fwux
椆	fwhl
栍	fwgv
欆	fwwb
樧	fwfq
枂	fwyv
巭	fxgu
朻	fxgv
椂	fxkv
梉	fxhf
棥	fwwf
椶	fwxe
棴	fwxb
鐢	fwww
榝	fwfq
椔	fvjt
椮	fvgt
朰	fviv
乶	fviu
坙	fvht
櫇	fvdm
桳	fvgd
巰	fvfq
剄	fvfm
柌	fvfl
桙	fvwn
楈	fvnw
榒	fvss
䴕	frmy
殧	frod
銐	frmw
梸	frmd
槇	frmt
鮤	frmt
殩	frmp
殥	frot
鵏	frou
樢	frov
櫸	frsa
殦	frro
殮	frrl
楰	frte
殈	frqm
棿	frqr
殌	frff
殐	frfl
樬	frey
槝	frjs
楿	frjr
殨	frlm
㱮	frlk
殫	frld
栺	frjr
殟	frjm
殎	frgt
殗	frgk
殕	fril
柇	frhv
欟	fslm
槗	fsll
栤	fskv
柡	fskv
櫗	fsmo
柨	fsmv
欂	fsia
欌	fsgs
櫣	fsgp
橗	fsjw
棤	fsjr
櫔	fssk
楳	fssf
栭	fsrv
檋	fstg
栫	fsnv
櫪	fsrn
迃	fspd
枤	fsqv
櫙	fsgl
殙	frtj
殅	frwg
歾	frwt
殔	frxk
肂	frxa
梑	fruo
樅	frtn
椛	fser
榞	fsem
栨	fsei
﨓	fsea
榵	fsar
槈	fsac
柭	fsbo
繶	bijy
綕	bhyi
覴	bflm
綥	bjaj
絒	biqc
紶	bhvv
剭	bhmd
纈	bhlm
繨	bhup
繬	bhtl
緦	bjyi
緆	bjwt
纗	bjwl
紻	bkgd
絧	bkfl
纝	bjjb
綶	bjfv
緹	bjfn
縄	bjkd
縪	bjsa
縨	bjmh
絚	bfwf
杘	bfvh
緁	bfxn
緙	bges
緗	bfmf
邆	bflp
絉	bfod
犚	bhaw
螱	bhak
癷	bhgu
緎	bglf
纉	bggm
綇	bgos
綊	bgtt
縥	bgrh
絖	bmhw
縎	bmgs
繯	bmfr
彑	bmmm
緽	bmmb
圅	bnud
緔	bnss
紪	bnri
絗	bnlv
歰	bobn
鶥	bmro
繝	bkwy
彔	bkvm
巶	blck
綤	blcb
糪	blop
鼊	bloj
䴙	bloy
欩	blei
繢	blkm
繴	blob
刟	blmd
縜	blmb
絽	bllv
繰	bllf
叒	bbbu
毲	bbbr
糿	bbds
逫	bbbp
刕	bbbd
欼	bbbe
顙	bbbm
飝	bbbk
縔	bbbf
縀	bbsb
綛	bboy
縉	bauj
搄	ayff
揯	ayff
揤	axvx
聉	axxg
挧	axxi
拹	axxx
搚	axxw
糽	bans
抌	ayqr
聸	aysu
掵	ayxj
捔	aytn
緥	belf
絥	besq
縚	berj
縘	bevg
緱	bebq
絈	bebs
紨	beac
屚	bdyh
綘	bedn
緶	befw
纅	bevf
綒	bevk
繊	bdgk
縅	bdfc
緡	bcaj
緸	bdht
緀	bdxc
絾	bdvi
紑	bdus
繧	bdsv
縬	bdkm
遦	bdmp
剶	bdmd
繥	bdlv
縿	bvvt
紭	bvvv
綼	bwdi
緿	bvly
紴	bvps
縃	bvnw
緵	bwxe
屫	bxel
纘	bwqm
絇	bwlv
緫	bwty
絴	bugs
緧	bugo
綐	bulq
繜	buga
縒	bufo
絵	btsv
繅	bvjf
纊	bust
絣	busj
絋	buvv
綈	buvq
龴	buuu
孎	cbkk
嬵	cbem
媉	cbhk
隥	cbfu
隦	cblo
鴖	caro
娺	cbbb
婮	cbdg
奻	ccnn
邚	ccjn
媁	ccin
姧	cchg
陦	cdac
嫷	ccsw
妜	cbte
妑	ccbn
婽	cbsb
鴑	cbro
姄	ccai
緷	bygc
絼	byks
繍	bxpt
刡	camd
睯	caem
繺	byxu
絩	bqss
絎	brah
紃	bqcs
屨	brlc
絬	bres
縭	bpxv
繵	bonf
綡	boma
縞	bols
綂	bolq
遟	bopd
袰	bory
縼	boqn
縇	boff
紸	bogn
緕	bpts
綧	bovk
纃	bous
縍	bouo
纐	botm
繱	bswy
絠	bswy
屒	bsnh
紎	bsqs
繿	bsqm
刔	btmd
刅	btid
緍	btaj
絟	btgn
緰	btfm
縦	brun
屘	brvk
繌	brwe
鳲	broh
纄	bsep
緓	bskg
緢	bsjt
縸	bsjg
縙	bsar
縓	bsem
絘	bsei
紏	bsdi
抾	ahvv
擣	ahva
聙	ahwy
撻	ahup
掅	ahwy
撎	ahyu
聐	ahlv
挃	ahko
抴	ahio
捇	ahtt
攈	airh
摌	aiqw
攗	aipm
摬	aijq
搟	aghg
聀	aggr
捙	agco
丣	agbu
畱	agbj
挗	agvg
摤	agww
捓	ahcj
摫	agmx
聝	aglf
摙	agpd
聗	agtt
摏	agrj
搸	agrh
撍	agqj
捛	allv
拀	alqr
擻	alde
聵	alkm
攄	amjy
攎	amjm
摢	amqa
摣	ammi
攞	ambw
挄	amhw
捑	ajxg
掲	ajwr
擝	ajwm
撔	ajom
摱	ajmb
攂	ajjj
挊	akak
掆	akuj
擃	akss
擈	akut
戨	alag
㧏	akwl
抰	akgd
耼	aksi
撋	akgn
掓	akmb
瓼	akkw
捚	akko
択	abod
捤	abrm
搱	abox
摨	abkw
攭	abdk
撜	abfu
撱	acsw
邒	acjn
摂	aass
㧐	abbu
顳	aaam
烲	aeuo
乴	aevi
銴	aewj
擨	aeme
裚	aeor
扷	aeoo
掚	afmr
揦	aflm
擟	aftw
揊	aflj
搷	admt
聴	admy
擮	adgw
擜	adks
搮	adfv
搣	adfu
瓸	adjr
撠	adjg
捳	aefj
拞	aefi
捠	aeft
梊	aefv
扻	aeio
捀	aedn
娎	aecn
捿	adxc
拪	adxo
挬	adyv
毮	amqr
攍	aucn
聡	atvy
捴	atvy
扵	atsi
扸	atpo
抙	atuo
抮	atto
扴	atti
攕	attf
揂	augo
掋	auto
聠	ausj
鄑	aujc
攁	augv
聏	asrr
抎	asvv
拻	asuo
攊	asrn
拵	asnv
耺	asvv
擏	aswe
攃	aswh
聁	atbd
捪	ataj
聕	awlv
瓩	awkw
挿	awjr
捦	awjo
旾	axjr
拁	axlv
揔	awty
㩳	awwb
聭	awur
撨	awuo
揈	awua
扟	avdi
撪	avgg
摷	avjf
乤	avik
拡	auvv
攚	auul
掶	auxt
聈	avxk
聫	avvg
撡	avvo
聮	avvu
抁	avqr
擸	avnb
聹	aoya
聺	aowh
甅	askk
聜	apfo
攠	apli
摉	aptr
搈	aptl
揬	apsq
攛	aprb
攩	anne
攌	anmr
捗	anma
捾	aobb
聤	aoan
挸	amxo
挔	aory
攇	aody
聢	aofn
擯	aofm
攑	arsa
擙	arpg
鵈	aror
瓱	armw
擆	ashj
擛	ashf
搑	asar
摼	asbh
挋	asco
擹	asfe
聥	aqlk
聅	aqir
擌	aqgt
搩	araf
颪	arfk
逰	aqvp
擶	aqum
聎	aqss
騻	dgww
磢	dgww
驧	dgwp
硦	dgsj
磽	dhhh
豣	dhhg
馯	dhgm
硈	dhlv
駤	dhkm
硨	dgch
雬	dfvy
豧	dfus
趰	dftw
硹	dftv
韯	dglf
覉	dggl
𢦏	dggi
碊	dggg
騸	dixx
豟	divi
礲	diwm
霐	divv
霃	diyq
碋	djal
砨	divi
霶	dioo
駲	diqc
霠	ditv
霗	ditb
𠦝	djdi
駻	djhg
靁	djjj
霷	djjt
靊	djdu
靐	djdj
騍	djfv
磑	djfu
硣	dhvk
駍	dhue
勡	dhxk
硓	dhri
硳	dhtt
騿	dijd
驝	dhyf
霮	didx
趇	didk
雴	didy
駈	defi
碫	defq
麱	defu
碷	dedm
駱	delv
礄	dell
騡	dekv
蟴	dekc
駇	dehm
馸	dejm
赼	deik
麮	dehv
騳	ddmm
駀	ddom
顂	ddmb
礂	ddlv
熭	ddxu
霋	ddxc
麪	deav
豩	ddss
礝	ddsr
礭	ddwi
豮	ddsk
硥	ddto
磃	demu
碄	dffv
趚	dflv
鸘	dfmr
馷	dfmv
麧	deqv
麲	demx
麶	depv
礉	deoe
覄	desq
磘	dewo
麭	dewc
麬	devp
磤	dexq
騱	devg
硡	dosv
騯	douo
豥	dois
騌	dohs
碂	dohs
靌	dogm
驙	donf
霽	dous
硛	dpih
遤	dpdm
逨	dpdl
駺	dovn
驐	dove
硱	dnfv
駰	dngd
硘	dnlv
砋	dnih
磍	dodl
礗	dofm
驞	dofm
礃	dntu
碠	doan
礆	drlh
騪	drnb
趏	drek
霺	drfq
碸	drfh
驄	drey
騬	drur
磫	drtn
豵	drtn
磶	drwu
趓	dqfv
䶮	dqfg
趃	dqgu
豛	dqhs
騈	dqhh
馼	dpwm
砤	dqcy
馲	dqai
騀	dqag
雿	dqss
駣	dqss
趒	dqss
趀	dqxq
硟	dqnx
駳	dqnx
駎	dkom
顣	dkmm
蜝	dkcj
駚	dkgd
畞	djyo
雵	dkgd
駧	dkfl
叓	dlbu
霵	dlag
礀	dkwy
邫	dlcb
歖	dlei
霻	dksu
驜	dkut
驆	djsa
騉	djrr
硸	djsh
騴	djoc
豱	djmn
驨	djwl
磮	djtn
螒	djtk
倝	djte
硶	djtv
駫	dmhw
礋	dmhd
尳	dmgo
驉	dmkg
趠	dmjd
豠	dmis
剘	dmdj
矵	dmdh
赻	dmqp
夓	dmre
碵	dmmb
嗭	dmlr
夒	dmne
硵	dmnw
龗	dllm
霣	dlmb
尵	dlkm
趮	dllf
礹	dlle
孁	dllc
駽	dlwy
婹	cdcn
隲	cmqd
婋	cmun
婟	cndg
媫	cmxn
娊	cmxn
韣	cmwk
嬽	cmng
姯	cmhw
嬕	cmhd
嫼	cnen
姲	cocn
埅	coht
婃	cohs
婝	cofn
騭	cnmd
隚	cnht
隵	cmfg
阥	ckvj
媀	ckyn
孄	ckfu
姛	ckfl
妽	cken
媤	cjyi
娯	clxt
巼	clri
孍	clle
婔	clin
陫	clij
嬠	cllf
妕	clns
妷	cqgu
暓	cqej
敄	cqeh
奦	cqeg
鞪	cqeg
鶩	cqer
熃	cqeu
姂	cqpe
陹	cqsj
阩	cqsj
劀	cqkm
鷸	cqkr
矡	cqmb
嫎	couo
韕	covk
媯	coww
婛	coma
嬣	coya
騖	cqed
隣	cpra
娐	cevk
妡	cejn
嫍	cerj
嬓	ceoe
姉	cfmv
姃	cfni
媡	cfnu
阷	cfni
敶	cfje
陚	cfgn
螴	cfjk
娻	cfjr
妦	cdnn
娝	cdlv
婡	cdln
嫴	cdox
妚	cdun
隭	cdsr
隫	cdsm
隇	cdfc
媙	cdfc
娸	cdjn
陻	cdht
娦	ceft
檃	ceff
婇	cefv
韟	cegd
姙	ceen
媅	cdxi
嬭	cftw
隡	ciqw
嬑	cijy
嬂	cigj
媇	cifv
媣	ciyf
嬍	cjfe
嬦	chva
嬙	chtl
隯	chva
嬄	chyu
隞	chwe
婈	chte
奾	cjsn
媏	cjsr
婩	cjsh
韠	cjsa
婫	cjrr
隑	cjfu
韞	cjmn
媋	cgjr
隁	cgjc
塦	cght
陭	cgal
嫥	cgac
陘	cfvf
陠	cfuj
陓	cgfs
韚	cgei
韘	chfv
媎	chjr
韎	choi
韥	chmm
嫧	chmb
媴	chlr
嬯	chlh
嫤	cgsi
嫊	chbs
韢	cgyi
砙	dawh
瓳	dawg
駵	dagb
霯	dbfu
洯	dbkv
騛	dbkm
蛪	dbkc
騤	dbfg
嬧	cxfm
媰	cwxx
娽	cxkv
陎	cwti
娷	cwsf
陱	cwpm
婅	cwpm
孇	cwwb
嫶	cwuo
妼	cyqp
陥	cynj
媍	cymb
険	cyte
嬆	cyxx
隖	cywj
韐	cyei
嬥	cxxw
媈	cygc
婏	cylo
嫓	cykr
鼜	ddbk
鼞	ddbh
馶	ddbu
磹	ddjd
雼	ddhy
磦	ddhs
驦	ddfm
壴	ddd
嫑	ddcn
驫	dddm
豭	dbsb
碬	dbsb
騢	dbsb
赽	dbte
硧	dbtn
砪	dbmh
駋	dblv
碿	dbmw
駅	dbod
郲	dcjl
霱	dcql
騥	dcqf
攳	dbxa
驏	dbvv
驋	dbvq
駶	dbvl
觢	dbyt
孏	csku
嫹	cskt
韤	csmo
媠	csfw
媆	csgd
娾	cshh
陾	csgd
姷	cswy
嬞	cswk
妢	ctbd
姏	cssi
韛	csqt
嬳	cswb
娂	csti
嶞	csfj
婾	crfv
隉	crfo
姀	crhn
姳	crlv
﨩	crjs
孂	cqvm
阣	cqvi
隝	croj
韍	csbo
妭	csbo
媶	csar
嫨	csfg
隓	csff
媷	csac
姼	crrk
媘	crre
嬩	crst
嫝	cuxk
媊	cuwm
嬨	cuvy
婒	cuuo
隒	cuxt
姢	cvwy
媑	cwkk
婎	cwin
陮	cwij
阭	cvqr
娹	cvov
陖	cvte
嫸	cuul
妎	ctti
婣	ctxf
嬼	ctwm
妐	ctvv
娢	ctol
嬶	ctja
隂	ctha
姾	ctgn
陯	ctfn
婨	ctfn
嬒	ctfj
媹	ctjt
阦	cuoj
嬫	cuuf
嫬	cusu
媨	cugo
娮	cuan
嬘	cudp
媄	cugd
嫅	cufo
鐆	cudw
菐	kugu
䦟	ktth
糳	kudp
蜵	ktxf
蚥	ktwl
誾	kuan
蛕	kswy
閽	ktaj
蚳	ktao
仧	ktes
敟	kste
闀	kstc
閎	ksvv
蚅	ksvi
閄	kten
閝	ktob
鹶	ktov
蚙	ktov
蛿	ktol
鹷	ktob
螑	ktsq
蠄	ktpv
蜦	ktfn
闂	kugv
蚫	kwck
蜔	kwjt
閵	kwin
﨡	kwgc
彂	kvqi
闗	kvvu
蟣	kvvt
羀	kwwj
蝩	kwkk
覵	kwmx
罓	kwlf
鷳	kwro
虳	kwod
畃	kwod
蚒	kwob
焛	kuon
鸈	kutr
螠	kutm
蟅	kusu
蠩	kuhj
閲	kulq
黺	kumb
闞	kvae
蜬	kvkx
觃	kvkx
虸	kvkc
蝷	kuux
蠑	kuuf
鹻	kuxt
螊	kuxt
閍	kogn
蚄	kogc
蝊	kofn
蝖	koff
閌	koqj
閙	komv
螛	kodl
迧	kpde
螏	kpqi
蜶	kotd
蠰	kosr
螪	koul
蜟	kovw
閬	kovn
蜳	kovk
蠌	kmhd
螖	kmgc
蠉	kmfr
蠳	kmmc
闅	kmmb
蛅	kmlv
蠦	kmjm
蚛	klns
蛽	kmbc
錖	kmbw
裻	kmbr
蜠	knrh
闛	knht
閫	knfv
蟔	knec
蠷	kmmw
虲	kmoc
泴	kmnv
蜖	kmsi
蜆	kmxc
豑	ksfq
螮	ksfm
閗	ksdi
蛂	ksbo
蝆	ksao
颒	ksdk
頮	ksdm
蟵	ksfa
蠀	ksem
冔	ksla
蠇	ksky
蝧	kskg
蠴	ksmj
閁	kqpn
蟱	kqsu
蛌	kquc
虴	kqai
蛈	kqgu
蛥	krrk
蜌	krrh
蝔	krre
螕	krwr
闏	krfn
閐	krmn
蟍	krmf
咞	lfsj
啢	lfmr
噖	lggv
呚	lehv
嗁	lemu
喒	lemj
囇	lfki
哹	levk
嚛	levf
焁	leuo
喖	lfdg
嚫	lifm
嘊	ljsh
啱	ljdh
喅	ljid
嘵	lhhh
噆	lgqj
呭	lhiv
啨	lhwy
嘋	lhve
嚋	lhva
咠	larv
啹	lbdg
噝	lbbs
唞	lasd
咓	lawv
蝬	kwxe
蟰	kxtf
䦛	kyxv
蜭	kyrj
鹸	kyte
蛫	kysv
蠗	kxxw
蛡	kxxi
翈	kxxi
啚	ldnl
咟	ldjr
嘾	ldjd
甊	ldla
哸	lecn
唕	ledi
啿	ldxi
嘜	ldeh
嚖	lddy
唨	lcmi
畍	jtti
昣	jtto
嵢	jtol
曍	jtsd
昑	jtov
崷	jugo
嵡	jtvx
畻	jugh
嵄	jugd
嶟	juga
嵳	jufo
峜	jtni
嶥	jsue
嶡	jsue
嵟	jswi
曔	jswe
崘	jtfn
暞	jtfv
嵧	jtjt
畭	jtff
岻	jtao
晭	jwhl
甠	jwgr
崯	jwjs
嵾	jvvt
崥	jwdi
崜	jwsf
猒	jwsq
敡	jwtb
嵻	juxk
昿	juvv
晜	juvq
巕	juyc
巙	jute
嶸	juuf
岋	jvod
嵶	jvss
歞	jvve
曊	jvtm
岪	jvti
屷	jvjs
嵹	jvlk
崡	jvkx
崰	jvjt
疂	jssm
嵭	jouo
崹	joum
昗	joti
暆	joqc
畩	jory
峩	jqag
岤	jpxs
畮	jqbm
辿	jpds
嵱	jptl
崓	jndg
曭	jnne
峴	jmxs
巀	jmwg
昘	jogr
曢	jogm
嵪	jols
峕	jojr
畡	joit
晐	joir
峖	jocn
晥	jofh
嵽	jsfm
嶏	jsgb
嵸	jrtn
鷝	jsar
盢	jsmn
鷐	jsro
嶆	jsjj
暯	jsjg
亗	jsis
屵	jshs
曂	jskt
崣	jrcn
曻	jrao
鴫	jrot
嶌	jros
崻	jrha
嶮	jrls
暀	jrog
峲	jrmd
閠	kgod
蚟	kgnc
闚	kgmx
閾	kglf
螼	kgsi
蠮	kgqx
螹	kgej
閳	kgcn
蚷	kgbu
蝘	kgjc
蝒	kgic
蟯	khhh
閈	khgn
蝫	khjr
闧	khlp
蝳	khbm
閸	kfja
戙	kflg
蛃	kfkt
閿	keyb
蛜	kexq
蟡	keww
螇	kevg
虶	kfau
蛵	kfvf
蚞	kfvc
蚈	kfsj
蜯	kgao
螎	kfln
蛚	kfrm
朄	kfnu
蜽	kfmr
閊	kjsn
蚦	kksi
閖	kkvn
蝄	kkuu
闦	kksu
蟙	kigj
蟝	kigf
閚	kidn
閯	kimq
闙	kile
螰	kilc
螧	khrj
䞍	khwy
蜐	khvx
蟽	khup
蝿	kjkd
閶	kjjr
蟃	kjmb
鷼	kjro
閺	kjpw
濷	kisr
蝋	kiqa
蠬	kiwm
嶑	jyld
嶭	jyox
畂	jyod
峆	jyes
蟶	kalg
閇	kakn
畁	kajo
閜	kalv
閅	kann
嵨	jyws
嶖	jyxx
嵏	jwxe
峍	jxao
岄	jwys
鶍	jwtr
焽	jwuo
昢	jxxg
曓	jxxf
曃	jxkp
蚘	kdoc
閪	kdxn
蛨	kdjr
沯	kdhv
蠘	kdgw
蛒	kelv
闎	kekv
螔	kemu
蚸	keod
螩	kenf
蚚	kejc
蟘	kegm
蝞	kbmf
蠾	kbkk
蚗	kbte
虭	kbdc
蝝	kbds
闄	kdcn
沀	kcuv
蚽	kdfi
蝛	kdfc
蟖	kdej
瞁	mmsq
虤	mmuu
鸎	mmro
鷶	mmro
盀	mmno
覞	mmxx
鑍	mmwj
戵	mmwg
贁	mmeh
刞	mmdi
賏	mmbb
睊	mlwy
尛	mmma
贙	mmmb
奰	mmmg
虘	mmiu
帵	morv
齩	motw
賋	motw
髇	molg
賅	moib
貥	moqj
䁖	mpcn
髍	mpag
矃	moya
賩	mohs
幥	mntu
欳	mnei
贘	mnmb
睻	moff
髕	mofm
罜	mogn
瞚	moft
罯	mijr
罿	mikk
齴	miqt
䝼	mhwy
齖	mhyc
齭	miej
帹	micn
睅	mjhg
睤	mjaj
尡	mhjr
齛	mhic
幘	mhmb
韑	mhci
盰	mhgf
幉	mhfv
幬	mhva
眎	mhsf
瞨	mkug
梷	mlbf
齥	mkqp
睓	mkst
賵	mksm
瞣	mlly
眖	mlqr
貺	mlqr
覘	mlmx
齞	mlti
贃	mlly
睈	mlgn
頕	mldm
賗	mlln
幧	mllf
幆	mjwx
戯	mkgg
瞤	mkgn
勴	mjyx
齙	mwck
齝	mvlv
貱	mvpb
矄	mwne
揱	mwmt
雐	mwiu
蠽	mwgk
賯	mwjv
劅	mwkm
瞓	muqc
賆	musj
賧	muuo
賹	mutm
賘	muho
眻	mugf
覎	mvkx
罺	mvjf
罤	muvq
虍	muuu
瞊	muxl
睴	mygc
齳	mygc
敹	myqe
賱	mygc
踙	nabu
咼	naa
肻	mywy
髉	mywi
賝	mytf
睷	mxax
齺	mwxx
戱	mxfg
虝	mwto
覐	mwwl
齓	mxic
郻	mxvc
賿	mxxt
眳	mrlv
齨	mrjc
齯	mrqr
瞗	mrof
齔	mric
覹	mrfq
矀	mrfq
郹	mscj
矁	mruy
瞛	mrtn
睋	mqag
䲣	mqeh
盵	mqvi
瞴	mqsu
幠	mqsu
幯	mqxx
齚	mqmo
賉	mqmn
毟	mqrm
罖	mtod
矏	mtpo
睔	mtfn
瞺	mtfj
䱷	mteh
賒	mths
瞈	mtvx
羉	mubb
睉	mtth
齘	mtti
幭	msmo
贎	msky
帪	msnv
瞸	mshf
瞙	msjg
矆	mswb
眃	msvv
眡	mtao
貾	mtao
䴗	msya
睰	mssl
贆	msss
咊	lrhv
靟	lrmi
啝	lrlv
噞	lrlv
嘸	lqsu
哘	lrah
唀	lrvj
嗕	lsac
嘥	lrnn
唲	lrqr
哛	lrtb
噾	lpij
㘎	lpve
嚌	lous
噃	lqpj
囄	lpxw
吘	lqdi
嗿	ltom
噲	ltfj
嘦	ltdc
哾	lulq
嚠	ltwm
哶	lshg
嚈	lsjs
嚦	lsrn
囆	lskk
嚂	lsqm
猆	lsqi
㖞	llkt
鄵	lllc
喿	lllf
囅	lljg
鄲	lljc
嘼	lljl
辴	lljs
鷤	lljr
劋	lllm
丳	llti
唺	lkst
嚉	lkua
呥	lkht
覨	llfm
遌	llfp
卾	llfx
嚪	lkyr
㘚	lkve
嚻	lldl
郘	llcj
呬	lnqr
噛	lnpx
迚	lnpd
囃	lotw
唹	lots
囐	lmfs
嘂	llxl
鄖	lmcj
嘪	lmmb
噦	lndm
囎	lmuj
哯	lmxv
鶰	lmro
齗	mejc
虗	mefi
帿	mebq
勮	mdxk
骽	mecn
罦	mevk
虪	menn
幖	mdhs
郥	mcjb
幃	mciv
貤	mcyb
瞲	mcql
贉	mdjd
豦	mdsu
帺	mdjv
瞦	mdlv
顝	mdmb
幁	mdmb
虥	mggg
帴	mggg
賰	mgjr
睶	mgjr
骮	mgyg
瞘	mgll
盶	mfhw
貦	mfhw
賕	mfko
骬	mfau
賻	mfac
罧	mffv
虨	mfft
骵	mffi
齽	mffh
齾	mflm
幊	mfmb
吀	lwkv
哠	lwlv
嚑	lwne
剈	lwmd
瓹	lwaw
哅	lwwx
噚	lxfa
肙	lwyv
呁	lwsi
鷕	lwro
嘃	luxw
唴	luxi
嚝	lust
呞	lvfl
吇	lvkv
罬	mbbb
罻	mbha
帄	manv
眲	marf
羄	mbmj
羂	mblw
眧	mblv
齠	mblv
嗋	lxxw
𡭔	maaa
齱	mabu
嘝	lytd
餥	lysi
祣	hqry
圥	hqrt
垁	hqit
塲	hqjt
殻	hqjf
垗	hqss
堸	hrft
垀	hqua
墲	hqsu
垳	hrah
埌	hovn
塝	houo
鬡	hoya
垶	hoxt
鬤	hosr
圫	hqai
坹	hpxt
镻	hqgu
祑	hqgu
埪	hpfo
迣	hpdi
塎	hptl
堗	hpsq
禷	hpsm
壦	hslw
祳	hsns
髵	hsra
墴	hskt
塻	hsjg
鬕	hsjg
墸	hshj
坋	htbd
坁	htai
夌	hteh
垬	hsti
塃	hsuq
堦	hrre
墺	hrpg
垑	hrrk
鬁	hrmd
塡	hrmt
鳱	hrog
墷	hsfd
埖	hser
鬗	hsfr
堶	hsfw
鬌	hsfw
圦	hrut
塖	hrur
坺	hsbo
堈	hkuj
埛	hktl
堣	hkyt
壛	hkyr
鬜	hkwy
圵	hkst
鬞	hkss
墤	hlkm
壧	hlle
壝	hlkp
祌	hlns
祦	hlfg
塷	hklt
堓	hjsh
乽	hjvi
煑	hjuo
埁	hjtv
堒	hjrr
墹	hkjr
堨	hjwx
鬄	hjwt
墔	hjwi
禗	hjyi
壋	hnjt
祵	hnfv
勩	hmxk
堝	hnat
垷	hmxt
塇	hoff
禞	hols
坾	hoan
垨	hoac
圡	hodt
垻	hmbt
貰	hmbi
壉	hmds
翓	hlxx
埍	hlwy
皾	hmmv
覿	hmmm
夁	hmnd
垙	hmhw
坥	hmit
壚	hmjm
礼	hxis
壭	hxjf
凷	hxgt
䴖	hwya
堫	hwxe
埐	hxyb
垥	hyet
垖	hydt
鴄	hxro
逺	hxrp
堹	hwkk
靗	hwmh
坸	hwlv
嗸	hwel
嶅	hwej
摮	hwet
兀	hwww
圽	hwto
禶	hwqm
圴	hwod
礿	hwod
靔	hwqq
靝	hwqp
澑	iagj
滒	iall
鬇	hyxv
埩	hyxv
灄	iaaa
涺	ibdg
湁	iaye
禈	hygc
堚	hygc
亄	hyfx
墖	hyjt
塓	hyjt
坈	hyqj
髧	hyqr
塠	hypd
祪	hysv
壷	hylf
镹	hyod
嫯	hwec
鬠	htfj
塕	htvx
壪	hubv
耂	httt
慹	hudy
壿	huga
禉	hugo
堘	hugh
漐	hudk
蟄	hudk
贄	hudm
褺	hudr
瓡	hudq
禭	hudp
﨏	httl
勎	hthx
燅	hthu
鼀	htjm
塯	htjt
坴	htht
堬	htfm
驇	hthd
暬	hthj
圿	htti
坽	htob
坅	htov
迲	hvpd
髲	hvpa
鼁	hvjm
坮	hvlv
唟	hvlr
叝	hvxb
墋	hvvt
郬	hwcj
塮	hwac
堖	hvrw
禙	hurw
塧	hutm
鬀	huvq
埮	huuo
祱	hulq
赱	huod
垜	hvfv
翿	hvfx
魗	hvfw
湀	ibfg
隿	gwiy
醀	gwio
奞	gwid
酳	gvwy
軳	gwck
奝	gwhl
輖	gwhl
珄	gwgn
琕	gwdi
玬	gwob
奟	gwwy
輣	gwwy
輷	gwua
珤	gwon
鴎	gwro
珗	gwqr
璡	gwpd
璳	gwtm
輽	gvgj
輺	gvfj
轈	gvjf
軐	gvdi
琷	guxi
𡗗	guuu
匥	gvsj
醦	gvvt
璣	gvvt
厺	gvvd
軩	gvlv
輡	gyrj
珎	gyma
匛	gyod
瓺	hawa
堟	hbds
圢	hant
玏	gxkn
輑	gxql
蟿	gxqk
檕	gxqf
礊	gxqd
玌	gxin
酦	gxbo
珒	gxao
匨	gxhf
璶	gxfm
匩	gxfh
珨	gyen
璭	gygp
璻	gxxd
珕	gxxx
輁	gsti
軛	gsvi
夽	gsvv
璼	gsqm
轞	gsqm
瓑	gsrn
軣	gssi
玵	gssi
瓁	gswb
琘	gtaj
奃	gtao
軧	gtao
匶	gswr
酭	gswy
鞾	gsfd
璍	gsfd
瑌	gsgd
軷	gsbo
憃	gryi
斳	gsej
歏	gsei
轥	gskw
韊	gsku
珔	gsnv
韉	gsiu
夳	gsid
冭	gsid
鷯	gujr
尞	gujm
羍	gugd
醈	guuo
刾	gumd
轙	guqg
玪	gtov
軡	gtov
靲	gtov
酫	gtgn
輇	gtgn
奅	gtmd
玜	gtvv
琂	guan
輍	gttl
鵊	gttr
塸	hgll
堾	hgjr
愨	hfyi
鞤	hhag
堼	hhah
镽	hgum
埉	hgtt
祴	hgsj
髨	hfhw
埡	hfja
坃	hfhw
坘	hfbm
龶	hfff
堛	hflj
镾	hftw
嗀	hflv
嗀	hflv
堜	hfnu
墕	hfnu
髿	himq
塶	hilt
墇	hijd
壠	hiwm
隷	hhxk
劸	hhxk
堁	hjfv
塒	hjha
塏	hjfu
禓	hjft
垾	hjhg
斱	hjej
壜	hjdv
髰	hhia
祮	hhlv
郌	hhlc
臸	hhkk
壵	hhhf
顤	hhhm
堯	hhhh
壔	hhva
奊	hhxg
埥	hhwy
堎	hhte
逇	hcpd
墢	hbvq
垊	hcai
墘	hdjv
墄	hdkm
塛	hdfv
髬	hdfi
墰	hdjd
墂	hdhs
繛	hbmj
墛	hbha
墱	hbfu
祒	hblv
壀	hblo
漀	hbqk
毊	hbql
殸	hbqh
塪	herj
臵	helv
垎	helv
墧	hell
堢	helf
墽	heoe
垘	hesq
孷	hesv
坿	heac
埓	heac
墭	hdvm
攼	hehg
堭	hegn
麺	hegi
塳	hedp
埄	hedn
淗	iwpm
鍌	iwqw
鵳	iwro
汼	iwns
龖	iwmm
驡	iwmd
竧	iwmd
讋	iwmu
鸗	iwmr
澅	ixhf
濜	ixfm
湕	ixax
泤	ixot
氻	ixks
堻	ixah
溾	iwus
汓	ivks
洆	ivkf
灉	ivlw
潗	iwfv
錃	ivwj
顅	iwdm
嶊	jawi
朂	jaxk
旫	jbdr
嵿	jadm
甼	jant
崫	jbxx
曯	jbkk
岹	jblv
岃	jbod
溮	iyfm
潒	iyld
蛍	iykc
峃	iyjs
瀈	ixxg
瀷	ixxt
瀥	ixxo
沵	iyma
敩	iyve
竫	iyxv
溩	iyws
汣	iyod
湌	iyss
鴬	iyro
瀶	isql
灆	issm
湈	issf
麎	isnl
瀎	ismo
浱	isns
汯	isvv
濍	iswy
汫	isti
鍙	istw
澬	isem
渮	isal
洍	iscs
渶	iskg
渵	isjt
竰	iskk
汅	isks
滣	islv
懣	isfy
渜	isgd
懘	isfy
竎	isjd
瀳	isiu
瀇	iust
渆	iusm
竲	iujj
潧	iujj
淃	iugv
涚	iulq
潎	iume
湭	iugo
滽	iuxw
溬	iuxv
漮	iuxk
湽	ivfj
溔	iuuo
瀅	iuuo
瀯	iuul
濚	iuuf
澇	iuux
濨	iuvy
竛	itob
沜	itps
涻	itre
竕	itbd
汄	ites
澮	itfj
漵	itfe
潊	itfb
潫	iugb
溠	iufo
瀸	ittf
鼝	itxb
洕	itwy
嵼	jiqw
嵃	jiqt
﨑	jilv
嵜	jilv
昈	jier
岦	jids
櫐	jjjf
壨	jjjh
疉	jjjb
曡	jjjm
嵦	jjfu
畼	jjft
崼	jjfn
暟	jjfu
晘	jjhg
嵔	jjgf
晆	jhht
嶤	jhhh
嶢	jhhh
崶	jhha
嶜	jgqj
峓	jgvg
畉	jgut
嶚	jgum
嶹	jhva
岼	jhue
崝	jhwy
圼	jhtr
峌	jhks
峔	jhri
嶁	jldc
暺	jlld
暃	jlir
汖	jkvs
晪	jkst
嶩	jkss
曗	jkut
峀	jkos
嶫	jkut
嶪	jkut
嶧	jmhd
岾	jmlv
嶵	jmli
曥	jmjm
嶉	jlwi
岲	jlqr
暥	jjoc
昍	jjrr
屾	jjss
曑	jjjt
曟	jjjs
晿	jjjr
峝	jkfl
岟	jkgd
崉	jkjr
畘	jkht
焸	jjuo
畕	jjtt
岴	jefi
嶾	jefy
岓	jejs
欥	jeir
嵈	jehb
崲	jegn
晠	jdvi
峸	jdvi
岅	jebu
嵠	jevg
峂	jesi
暚	jewo
峈	jelv
峉	jelv
嶠	jell
峳	jene
豓	jddm
豒	jddq
嶀	jdfs
嵅	jdfl
岯	jdfi
邖	jcjs
妟	jcnr
鄳	jcjm
嵮	jdmt
暊	jdmb
嶿	jdsr
嶻	jdgw
曋	jdjd
旪	jdir
崍	jdls
逿	jfwp
屸	jfos
嵀	jfog
鴠	jfro
峢	jfrm
峚	jght
輋	jggc
崨	jfxn
昮	jfxk
嶃	jgej
旲	jgdr
嶘	jfgg
晽	jffv
崊	jffv
崬	jfjr
崠	jfjr
疅	jfjf
峿	jfcl
敱	jflb
颽	jflr
剴	jflm
曧	jflk
敳	jfle
㳠	igpd
瀭	igtm
戠	igjr
湷	igjr
啔	iglv
淢	iglf
濲	ihff
瀔	ihfr
溸	ihbs
滙	igwi
漺	igww
潓	igyi
泧	igxi
濽	iggm
竵	ifln
浢	iflu
溂	iflm
瀨	iflm
瀜	iflk
漹	ifnu
泟	ifni
沞	ifmv
嬱	igec
汏	igds
壍	igeh
潖	iggc
魙	igew
涇	ifvf
淎	igao
灧	ijdc
韸	ijed
竷	ijee
湇	iiwy
瀧	iiwm
灅	ijjh
濐	ijhj
涆	ijhg
潉	ijjr
淐	ijjr
韼	ijep
戅	ijfy
淉	ijfv
韴	ijfm
漖	ihve
澾	ihup
汢	ihts
溒	ihlr
濇	ihtl
沶	ihss
洘	ihsk
澺	iijy
暜	iijr
湆	iijr
滰	iijq
灨	iijm
滻	iiqw
滬	iilc
涜	ihyq
淁	iicn
淭	iifv
澵	iife
瀐	idgf
澸	idfy
麜	idfv
渽	idgl
竍	idid
沰	idhs
瀻	idgt
麙	idfl
濝	idbs
瀮	idff
湱	iddh
潥	idpm
沋	idos
泋	idsj
濣	idjd
淔	idmi
竡	idjr
麢	idll
湏	idmb
淶	idls
溊	ibsb
麚	ibsb
浘	ibrm
埿	ibrh
潳	ibhj
竳	ibfu
灟	ibkk
漽	ibkw
淥	ibkv
戺	icke
濻	iclm
汿	icus
焈	icuo
慂	ibty
濰	ibwi
泦	ibyf
澔	iewl
乺	ievi
潙	ieww
濼	ievf
漑	ierq
沎	ieri
溣	ietn
盓	ifam
麠	ifjf
浗	ifko
湐	ifeb
潹	ifff
濋	iffn
泍	iffi
漜	iffh
漨	iedp
汳	iebu
湰	iefw
洉	iefl
浝	idto
洡	idti
泭	ieac
濦	iefy
湺	ielf
漞	iemx
垽	ieht
浌	iegg
滜	iegd
沠	ieks
峾	iejs
麡	ious
涥	iovl
涋	iosq
竤	iosv
渷	iotq
滧	iote
灖	ipli
潌	iphk
溛	ipqu
滵	ioyj
澝	ioyt
濵	iobm
瀗	iody
灙	inne
滱	iofb
竩	iomi
湤	ioqc
乼	iogv
漃	iokb
渢	irfs
湼	irfo
麘	irjr
竓	irmd
扄	irne
瀄	iqxx
泲	iqxq
潷	iqxa
湚	iqvw
滐	iraf
漗	irey
潃	irew
溗	irur
灚	irwm
澓	irqe
瀩	irqm
澚	irps
濥	irot
淣	irqr
汻	iqdi
澛	iqjr
塰	iqbh
瀿	iqbb
鼡	iqao
竔	iqsj
瀊	iqqm
泘	iqua
遃	iqtp
渪	iqlk
潪	iqlj
泎	iqmo
滊	iqpm
洀	iqos
潨	iqms
灛	ikld
渁	ikkv
灁	ikek
澖	ikfv
渱	ikfo
灍	ikue
灇	ikub
濧	ikua
漊	ildc
湒	ilar
湡	ikys
勭	ikxk
潣	ikpw
灎	iksm
涄	iksk
鶕	ijro
韺	ijsg
湠	ijsu
潩	ijst
遧	ijpd
澷	ijmo
澠	ijms
澋	ijom
灝	ijom
沺	ijts
潂	ijuk
畄	ijts
溭	ijte
灦	ijvm
桬	imqf
乷	imqv
竗	imqp
澯	imrp
瀃	imjt
瀘	imjm
竨	imjd
扂	imlv
瀴	immc
溑	immb
湞	immb
惉	imly
騗	indm
潿	inci
涃	infv
澢	injt
濹	inht
漍	ingf
甂	inaw
滮	imto
帍	imve
瀱	imsm
麆	imil
湂	ills
澏	illj
麣	ille
瀢	ilkp
洖	ilfg
麌	ilfg
塣	ilgh
潀	imet
潈	imds
濖	imhj
咅	ilvd
勏	ilxk
的	ewod
一	fii
了	vll
是	jfnf
不	duu
我	qagg
在	snht
人	tee
有	swyo
这	ppdw
他	ecye
来	fpmi
个	tnse
你	eyma
说	oulq
上	kss
到	hmdk
就	omdo
着	umfg
大	gdd
们	epne
道	utpd
那	vacj
么	qvvp
也	cyy
地	hcyt
子	vkk
下	akk
出	xxgg
时	jacr
看	tmfu
要	dcnx
她	ccyn
中	lnsv
没	iqhs
然	wsuo
里	kkk
为	oxod
过	apdc
自	tkk
好	cvkn
得	rjfa
去	hvvt
可	alvn
会	tsvv
天	fgdi
还	dpdu
心	yii
后	eflv
以	xote
小	maa
都	hjcj
和	rlvh
对	bacu
想	fmyi
能	vwrr
起	dbjk
之	pee
手	tuu
而	srr
只	ltiv
生	wgg
什	edie
身	wmm
头	sgdi
样	fugv
事	alxl
多	rrkk
己	bjj
家	odsb
面	gii
知	qlvi
开	fsji
如	clvn
无	fdoi
现	gkxn
很	rvnc
点	mluo
前	uwmd
发	xbod
经	vbfo
情	yhwy
把	acbo
老	hrit
些	nrsi
话	orea
已	bii
又	buu
声	hbhf
意	ijyi
于	faui
回	nlvw
笑	qeok
所	ieje
但	ejfi
眼	mvnf
成	dviw
方	ogg
年	qaok
见	kxx
当	mxla
女	cnn
真	dmti
两	fktt
力	xkk
气	qqq
从	ttee
长	thh
动	svxk
间	pjrn
国	ngod
走	dkk
让	oksa
被	pvpy
给	vyes
正	fnii
问	plvn
打	aano
明	jwyr
儿	qrr
法	ihvv
才	aqpu
几	qjj
行	rahc
定	ofnf
此	nrii
进	stpd
再	fkht
种	rlns
将	urac
实	osgd
同	kflv
最	jabu
本	ffiv
向	rnn
分	tbdi
十	dii
学	iyvk
高	oll
第	qvnq
感	dfly
怎	qmyi
神	hkes
听	lejv
边	xpdk
作	eqmo
其	djj
吧	lcbv
口	lvv
啊	lcal
因	ngdw
次	seii
军	yhcm
做	edeh
外	rmok
门	pnn
光	mhwa
风	qwlj
主	ognd
住	eogn
果	jfvr
与	sfik
全	tgne
二	sii
候	enbq
公	tvvi
相	fmfv
吗	lxmv
等	qhac
别	lxmd
色	ycbm
死	frri
张	vthg
部	ilcj
太	godd
日	jrr
少	mqpa
战	mlgg
理	gkkn
直	dmii
重	wkkk
王	gnn
像	eyld
脸	wtfi
比	rrii
快	ybte
何	ealv
水	kvv
名	rlvk
体	effi
呢	lbri
东	amai
叫	lxgv
西	dxx
应	uisu
便	efjw
放	oehg
马	xmm
难	bwiu
轻	hbfo
更	fjwl
美	ugdg
位	eide
关	ugde
机	fqjv
接	aicn
先	wqrn
文	pww
处	emoh
并	usje
望	uwgn
常	nmvs
四	nqrw
飞	vsii
师	ufmv
者	hjrt
安	ocnb
清	ihwy
刚	kwmd
跟	nvnv
月	wyy
信	euae
山	jss
爱	eysb
内	ktef
龙	dqpo
空	pfox
带	symv
找	aggo
入	ruu
李	fvkv
连	hpdc
吃	lqvi
场	hvto
平	hueg
思	jyit
林	ffvv
变	pbui
由	koo
受	eybu
亲	ifvd
命	yxje
目	mff
强	vlkc
男	jxkt
任	eene
该	ooia
路	nelv
今	tovi
海	iqbm
加	xlvk
远	fhpd
活	ires
特	whac
解	ytbw
电	kdd
世	hii
性	ywgi
表	hryf
许	oqdi
它	orib
立	idd
金	wjj
红	vfos
花	seri
转	hsxo
总	ulyi
算	qmsj
城	hdvi
队	ctej
孩	voik
反	ebuj
工	foo
始	cvlv
满	isft
新	ifej
兵	efti
物	wwto
离	pxkv
非	lii
虽	lkcv
云	svvi
似	exot
万	fwyi
干	hgg
通	btpd
认	otea
失	qgup
火	uoo
士	hff
五	fcii
惊	yoma
魔	pwua
竟	ijqr
姐	cmin
乎	quau
剑	tfim
往	rogn
量	jfkk
早	jdd
结	vhlv
怕	yebi
流	iovq
突	psqx
坐	ttht
斯	dejj
音	ijrd
紧	nbbs
指	arjr
拉	aido
杀	wfvl
半	uaoe
记	obja
且	mii
利	rmdh
合	yee
倒	ehmd
书	vvno
度	usfb
微	rfqj
步	nmai
教	hveh
喜	dlvd
越	dgxi
影	jomt
谁	owia
冷	stob
深	iytf
告	wlvn
象	ylds
容	ptlv
怪	ybht
传	esxo
钱	tfgg
提	ajfn
随	cswp
每	qbmk
双	bbuu
服	wxbu
击	axgo
哪	lvac
数	pceh
站	imlv
奇	galv
管	qobb
灵	xuol
刻	omdi
题	jfnk
衣	oryb
静	hwyv
伤	eqxk
百	djrh
拿	ytue
妈	cxmn
办	xtik
星	jwgr
化	erie
功	fxko
绝	vycb
系	qbsp
般	qqho
必	yqpi
业	kgg
尔	ymam
件	ewne
血	qmnp
代	egye
精	phwy
弟	uvnq
终	vesi
近	epdj
条	efvh
青	hwyf
界	jtti
司	vflv
整	flen
欢	beiu
字	ovkb
晚	jylq
民	caik
帮	dcmv
切	abdi
即	xvxj
忙	yuwi
或	glfi
暗	jijr
夫	guu
员	lkbv
根	fvnv
石	dhh
哈	lyev
夜	oero
父	twli
制	wkmd
友	sbuo
阿	calv
息	tyik
冲	slns
酒	igos
保	elfv
片	tpp
形	fsto
阵	chcj
南	dkud
决	sbte
请	ohwy
各	elvh
报	axbu
兴	itis
阳	cjrj
急	yxyi
语	ofcl
令	tobu
错	tsjr
及	vodj
刘	pmdw
极	fvod
识	olti
备	ejth
慢	yjmb
雪	dxly
苦	sdgj
若	sslv
收	xehg
底	utao
尽	bosi
准	swii
华	erdi
答	qyek
众	ttte
消	imwy
视	hkxs
罗	mrkw
敢	vaeh
留	tjtm
克	dqrg
乐	tmam
够	wlrr
跑	nwck
显	jkgr
嘴	lnrt
断	pxej
未	hee
势	ayox
句	wlvy
计	odia
论	otri
达	gpdd
则	kmdb
害	odlv
八	tii
单	ujdi
久	yodm
脚	whvx
德	rdmy
元	fhwi
脑	wpxg
雨	dyy
睛	mhwy
响	lrnv
刀	bdd
确	dytn
玉	godn
沉	iyqj
北	urie
格	felv
停	eoan
陈	cama
市	omvb
朝	djwy
喝	ljwx
族	oqqi
江	ifos
团	naqp
母	bmm
章	ijdd
装	uhor
亮	oqjl
客	oelv
照	jblu
乱	rxie
依	eory
黄	skti
修	enet
破	dvph
台	vlvv
球	gfko
呀	lhyv
送	ugpd
包	wcky
义	owld
诉	oeod
攻	feho
丝	vvfi
围	navi
玩	gfhw
待	rhac
复	qjeh
况	slqr
楼	fpcn
痛	pbtn
梦	ffrk
摇	aewo
期	dwyj
英	skgd
低	etao
帝	ouym
兄	lqrv
背	urwy
持	ahac
爷	twxj
皇	egnb
六	otib
穿	phyx
杨	fvto
政	fneh
运	svpd
居	bdgh
叶	ldiv
校	fotw
谢	owac
曾	ujuj
细	vjts
产	iqpd
睡	mwsf
希	wsmv
速	flpd
室	ohkb
另	lxkv
怀	ydui
露	dnel
异	csjk
写	ysfi
鬼	wuu
娘	covn
取	abur
式	gfoy
除	ctff
级	vvod
考	hskt
建	xaxn
愿	semy
招	ablv
饭	rebu
布	smvo
续	vdvg
程	rlgn
首	utke
观	bkxu
朋	wwyy
务	exkh
掉	amjd
赶	dhgk
忽	wtyi
注	iogn
术	fodv
甚	dxij
差	ufog
呵	lalv
展	bsgf
品	lllv
兰	usie
宝	ogod
香	rjrh
斗	sdii
故	dehg
雷	djty
段	efqh
顿	axdk
角	ytnm
疑	rqbn
护	aieo
闪	pten
需	dsry
调	owhl
类	pgdm
妹	chen
爸	twcb
线	vfgg
左	sfoo
派	iery
谈	ouuo
冰	skvi
敌	rehe
跳	nqss
支	dbui
约	vwod
您	eymy
顾	svdk
肯	nwyi
醒	gjwg
铁	tqgu
抱	awck
淡	iuuo
造	wlpd
伙	euoe
资	sekb
群	xqlu
集	wfvi
联	augd
号	lskv
节	sxjj
掌	ntus
赵	dwlk
密	oyqj
九	yff
病	pfkt
卫	xfij
米	pmm
威	dfcn
继	vpxi
渐	ihej
统	vovq
追	ypdd
亚	auej
简	qpjr
练	vavt
基	dhtj
选	wqpd
推	awio
改	behj
退	vpdn
味	lhev
举	itao
忍	boyi
历	sxkh
恐	fqoy
引	vnsg
试	ogfo
习	xii
导	cack
存	snvk
莫	sjgd
志	hyif
区	gwlf
汉	ibus
右	slvo
严	auqp
态	goyi
买	vsgd
社	hhts
佛	evti
议	oowl
树	fbac
止	nii
块	hbte
守	oacb
挥	ayhc
胡	dwyg
散	sweh
仅	ebue
隐	cyxy
怒	cbyi
床	ufvu
苏	sxti
料	psdi
股	wqhy
局	bvlv
班	gugn
图	nesi
岁	jrks
礼	hxis
独	rkcq
初	pbdy
福	hflj
顺	qdkb
狂	rgnq
默	nsqe
巨	gbuf
既	xvgq
松	ftvv
证	ofni
烈	frmu
否	dlvu
恶	auyi
治	ivlv
排	alio
费	vtkb
拍	aebo
医	gqif
寒	osts
哭	llsq
温	ijmn
府	ueac
担	ajfi
称	ryma
余	tffv
钟	tlns
泪	imfs
烟	ungd
仍	evje
具	mtii
忘	uyiw
恩	ngyi
毕	rrdi
蓝	snqm
陆	caxg
究	pyfx
抓	aeko
压	shod
呆	lfvv
河	ialv
迷	ppdm
枪	ftvi
组	vmis
权	fbuv
叹	lbuv
孙	vmak
卷	ugvi
查	fjfi
毫	orml
圣	bhtu
草	sjdj
较	hotw
胜	wwgy
遇	kpdy
史	lwlv
堂	nhts
防	cogj
据	abdg
猛	rvmn
骑	xgal
土	htt
卡	kmos
助	mxki
京	omal
银	tvnj
永	okvd
质	edkb
屋	bhkh
须	tdkb
副	fljm
换	aykg
刺	fkmd
属	bqlk
闻	parn
境	hijq
禁	ffhs
阴	cwyj
共	stij
负	ykbm
弄	gsjn
翻	qpjx
虎	muu
层	bsvv
喊	ldfl
逃	qssp
晓	jaqh
雅	hwiy
参	vgto
射	wacm
婚	ctaj
君	xqlv
划	gmdg
坚	nbht
价	etti
柔	cqfv
扬	avto
科	rsdi
按	aocn
狠	rvnq
野	kcuk
秦	grhu
秘	ryqp
熟	ovyu
置	mdmi
仙	ejse
模	fsjg
伸	ekee
波	ivps
肉	ktte
假	ebsb
齐	ptiw
舞	qsfa
脱	wulq
广	uuu
姑	cdgn
投	aqho
顶	adkb
致	hehk
责	hkbf
景	joma
维	vwis
设	oqha
坏	hdut
啦	laid
秀	rvjh
败	kehb
眉	bmfh
州	iqcs
药	svwo
承	vkfa
案	ocfv
狼	rovn
专	sxod
偷	etfm
画	fjxg
吴	lfgd
店	umlv
哦	lqag
弹	vujd
抬	avlv
标	fhsv
秋	ruoh
良	ovnd
际	chsj
状	usqe
烦	udkb
午	qdik
摆	amhv
戏	bggu
桌	mjfv
船	qqlv
短	qflu
村	facv
某	ssfv
摸	asjg
付	eace
演	ioft
规	gkxu
封	hhac
握	abhk
唐	uxlv
藏	sgxs
震	dsny
虚	mkgu
纪	vbjs
凌	shte
嘛	lpav
梅	fqbm
紫	nrbs
歌	alae
临	nqjr
毒	hbmf
宗	ohsb
著	shjr
索	dybs
印	tfxj
寻	xacl
湖	idwy
劲	bfxk
职	alti
恨	yvni
婆	ivcn
杰	fuov
羽	xxii
咱	ltkv
素	hbsf
凡	qodj
值	edmi
飘	dhqw
养	ugti
嘿	lnev
普	ukjr
宁	oanb
吓	lakv
夏	dmeh
读	odvg
牛	wnn
仿	eoge
胸	wwwx
富	oflj
宇	ofau
骨	mgg
智	qljr
纷	vtbd
升	qsjp
叔	kmbu
善	uulv
架	xlfv
卖	dvsg
袋	egor
网	kwwl
朱	wtin
骂	llxm
略	jelv
杯	fduv
环	gdun
罪	mliw
窗	preh
柳	ftmv
厅	sanh
搞	aolo
端	ijsr
洞	ikfl
适	rpde
拥	atno
释	qpba
洋	iugs
肩	iwye
闹	pomv
洗	iwqr
灯	uano
借	esjr
伯	eebe
免	ylqr
菜	sefv
验	xtfi
凤	qbuj
徐	rtff
型	fsmh
娜	cvac
暴	jstk
讨	oaca
辈	lhci
懂	yswk
腿	wvpd
妙	cmqp
效	otwe
优	edoe
套	ghad
丁	ann
趣	dabu
妖	ceon
束	flvv
杂	yfvf
诗	ohac
迎	txpd
舍	tree
旧	njrs
委	rcnh
笔	qrmk
狗	rwlv
鲜	qugy
纸	vtai
抗	aoqj
探	aytf
韩	djav
尼	brih
控	apfo
珠	gwti
抽	akoo
归	uxle
挺	aexn
奋	gjtd
陪	cilv
避	blop
园	nfhw
托	aqai
训	oqca
勇	btxk
聊	atmr
奶	cvjn
庄	uhtu
奔	gdsj
镇	tdmt
研	dfsj
配	gbjo
介	ttie
尊	ugac
冒	ksmf
虑	myiu
丹	woby
舒	trcu
蛋	vnkc
哼	lovl
宋	ofvb
济	ipti
妇	cxln
箭	quwm
择	abao
犯	rviq
欣	eeij
甲	kjj
欧	gwei
课	ojfv
扑	amoo
菲	slij
燕	sflu
曲	ksjf
躲	wqfv
玄	ovob
幻	vvio
茶	stfv
折	aejo
伊	exqp
傻	erwe
姓	cwgn
源	isem
洛	ielv
遍	inpd
臣	scc
犹	rdoq
占	mlvo
漂	idhs
挑	aqss
获	srsq
绿	vxkv
峰	jedn
疯	pqwl
森	fffv
妻	dxcn
恋	pyii
误	olfg
拜	tfdn
伟	eavi
移	rrrk
纳	vkte
党	nqrs
罢	mhvv
腰	wdcn
巧	fsko
孤	vquk
闭	paqp
圆	nlkb
碰	dukg
镜	tijq
软	heic
厚	sjvk
累	jbst
昨	jqmo
幽	jvvo
悲	lyii
丈	sodo
牌	twdi
降	ceao
颜	iqtk
偏	einc
省	mqmf
糊	pdwy
馆	robb
烧	uaqh
财	kaqp
舰	qkxo
汗	ihgs
奈	ghsd
操	allf
迹	ppdi
悄	ymwy
尖	mgda
鲁	qjry
锋	tedn
圈	nugv
油	ikos
撞	aikk
瞬	meya
忆	yvii
盖	umng
尤	doo
徒	rdkc
乡	vqps
概	fxvq
荡	sivt
艺	svij
增	hujj
祖	hmis
困	nfvw
殿	bstq
迅	vdpd
企	tnie
惨	yvgt
限	cvnj
凭	eeqj
剧	bdmd
碎	dotd
躺	wnsm
缘	vbds
凉	soma
腾	wugx
织	vlti
抢	atvi
替	ggjr
孔	vxik
康	uxkv
惑	glfy
唯	lwiv
率	ovsd
惯	ybdk
登	bflu
互	fbmi
盯	manf
稍	rmwy
宣	ofjf
唱	ljjr
剩	rurm
咬	lotw
育	ovwy
诸	ohjr
触	ytkc
晨	jsnr
策	qfkf
材	faqp
补	pmoy
私	rvvh
纯	vaxg
艾	swlj
贝	kbb
庭	uexn
挡	amxl
晃	jmhw
吉	hlvf
吹	leiv
仔	evke
仇	eyfe
农	yrym
征	rfni
帅	umve
附	ceac
缺	wbte
豪	odsl
亦	pii
杜	fhtv
努	cbxk
判	uamd
谋	ossf
胆	wjfi
尘	mhta
扎	axio
滚	iotr
迟	bopd
翼	xxjt
闲	pfvn
灰	suoo
朵	qfvj
盛	dvmn
梁	ibtf
晶	jjjr
餐	mrby
伦	etri
娇	ceti
侧	ekmd
愣	ymog
轮	htri
昏	tajr
抖	asdi
陷	cyrj
敏	qbeh
词	ovfl
颤	onlk
阶	ctti
苍	stvi
距	ngbu
川	qcc
扫	axlo
忧	ydoi
童	ikkd
丢	evvn
臂	blow
逐	dpds
傲	ehwe
戴	dgjt
芒	suwj
伴	euao
袭	dqor
供	esti
积	rlti
测	ikmd
遥	ewpd
阻	cmij
例	efrm
睁	myxv
岛	yjsa
瞪	mbfu
博	dfac
猜	rhwy
益	utmn
净	syxv
泽	ibao
炼	uavt
监	nqmn
鸡	byau
珍	gtto
伏	esqe
绍	vblv
曹	sjjr
爬	ecbk
丫	unse
炸	uqmo
凶	wxgl
郎	oxvc
宿	oedj
醉	gotd
革	gee
瞧	mwuo
奥	rpgd
输	htfm
忠	lnyi
颗	jfdk
仁	esie
鸟	yaa
骗	xinc
浩	iwlv
塔	hsye
绪	vhjr
枫	fqwl
拔	asbo
赞	wqwk
炮	uwck
凯	jbqj
邪	hcjy
芳	sogj
浑	iyhc
夺	gacd
宽	oskx
旋	oqvn
扭	abco
洁	ihlv
悉	qpyi
擦	aowh
慧	ddxy
典	ksti
赏	nkbs
评	ohue
纵	vtte
莲	shpd
雾	dexk
跃	neov
壮	uhfe
贴	kmlv
隔	cfln
健	exax
辛	oxx
抵	atao
彻	rabd
摩	ptua
编	vinc
肚	whty
插	awrj
磨	pdha
御	rqfx
耐	sacr
惧	ymti
氏	taim
辉	mhyh
扶	aguo
恢	ysuo
貌	yeqr
述	fopd
票	dhsx
录	xkvl
拖	aqcy
膀	wouo
鹰	uewy
孟	vmnk
递	uvnp
瑞	gjsr
货	erkb
琴	ggtv
踪	nohs
码	dxmh
玲	gtob
晕	jyhc
损	alkb
轩	hhgc
粗	pmim
掩	agkd
屁	brri
仰	etxj
零	dtob
盟	jwmn
贼	kgso
悟	yfcl
固	ndgw
讶	ohya
滑	imgs
郁	swcj
辆	hfkt
猪	rhjr
妮	cbri
挣	ayxv
旦	jfir
估	edge
甘	ssij
佩	eqfm
莱	sfpm
享	ovkl
吼	lvxi
构	fwvv
粉	ptbd
吻	lwto
瓶	usaw
偶	ekye
戒	gsjg
浓	iyry
毁	rfqh
销	tmwy
迪	kpdo
拒	agbu
绕	vaqh
勒	gxke
嘻	ldlv
尾	brmh
帐	mthv
废	uxbo
延	qnxn
敲	ombu
烂	uusi
曼	jmbu
厌	ssqh
宜	omib
羞	ubcg
喂	ljgf
吟	ltov
洲	iiqc
爹	twrr
艳	dycb
晴	jhwy
抚	afdo
协	dxti
央	kgdf
悔	yqbm
肖	mwya
缠	vukk
脆	wysv
痕	pvnb
伍	efci
寂	okmb
启	ilve
薄	sifa
侯	ebqi
劝	bxku
郭	ovcj
奴	cbun
鸣	lyav
彼	rvpc
扔	avjo
撒	aswe
豫	cyld
检	ftfi
针	tdij
耀	mhxw
痴	pqlv
姆	cbmn
篇	qinc
椅	fgal
熊	vwru
狐	rquq
蒋	sura
踏	nkjr
隆	cefw
括	areo
唉	lvqi
穷	pxkx
聪	auly
唤	lykg
泰	gkvu
版	tebu
旗	oqdj
仪	eowl
焦	wuoi
猫	rsjt
挤	apti
拾	ayeo
荒	suqr
姿	secn
域	hglf
脉	wokv
授	aeyb
狱	rosq
欺	deij
访	ooga
桥	feti
锁	tmkb
霸	dgwy
牵	gywn
池	icys
钻	tmlv
港	istc
廷	exnn
玛	gxmn
奉	gaou
扯	anio
夹	gueu
辞	roxe
岸	jshg
岂	jbjs
屈	bxxg
恼	ypxg
哲	aelv
季	rvkh
召	blvd
丧	dugf
尝	nsvv
载	dghc
瘦	prnb
颇	vdkb
茫	siuw
染	iyfv
肃	xtti
惹	ssly
乔	etio
趁	dtto
铺	tfuj
脏	wuht
吕	llvv
奖	urgd
倍	eilv
振	asno
婷	coan
牢	ownb
扰	adoo
溜	itjt
庞	udqp
臭	tsqk
悦	yulq
赢	ukbw
跪	nysv
侠	egue
泉	ekvb
劫	hvxk
炎	uuoo
泥	ibri
赌	khjr
魏	rcwu
罩	mmjd
疾	pqib
饰	rqmv
符	qeac
映	jkgd
漠	isjg
脖	wdyv
饮	reis
沿	iqlv
懒	yflk
肤	wguy
桑	bbbf
堪	hdxi
燃	uwsu
卓	mjdo
祝	hlqr
赖	flyk
宾	oeft
贾	dkbx
喘	ljsr
焰	uyrj
吵	lmqp
鞋	ghht
库	uhcu
裤	puhc
踢	njwt
姨	cgvg
酸	gvte
阁	pelv
箱	qfmf
冯	sxmi
邦	dcjn
钢	tkwl
促	enve
碧	gedh
援	aehb
忌	byij
抹	ahoo
锐	tulq
袖	pkoy
络	velv
嫁	cods
咒	llqj
撤	aove
键	txax
湿	ijkg
恰	yyei
审	okeb
贤	nbkb
刹	wfmd
袁	hlry
序	ucuu
湾	ipvg
崇	johs
墨	nhte
梯	fuvq
桃	fqss
驾	xlxm
浅	ifgg
径	rbfo
饿	rqag
疲	pvpb
搬	aqqh
润	ipgn
蛮	pkci
蒂	soum
涛	idac
予	cuu
勾	wvvy
惠	gyic
析	fejv
撑	antu
措	asjr
币	qmvp
薇	srfq
酷	gwlv
祥	hugs
怖	ysmv
侵	exyb
岩	jdhs
扮	atbd
盈	vbmn
斩	hejc
尺	bodh
签	qtfi
稀	rwsm
汽	iqqs
姬	cscn
愧	ywui
汇	igfs
粮	povn
仗	esod
笨	qffi
奏	gfgd
歉	uxne
甩	wxiy
怔	yfni
允	vqrv
竞	ilqr
祸	hlkt
耶	acjr
绩	vhkb
诱	orvj
呜	lewv
黎	rwqk
租	rmih
砸	dgmv
麽	pqvv
窝	plkt
弥	vyma
返	ebpd
匹	hxiw
啥	ltre
凑	sgfg
奸	chgn
陌	cdjr
叛	uaeb
核	foiv
卧	smoc
幅	mflj
眨	mqpe
耗	dtrm
洒	idxs
怡	yvlv
详	ouga
扣	alvo
哇	lhht
丑	bcc
勉	ylqx
孝	hvkt
矛	cqpu
氛	qtbd
衡	rqta
购	kwvv
汪	igns
妃	cbjn
罚	momd
棋	fdjv
缝	vedp
咐	leac
躯	wgwl
愁	ruyi
搜	arnb
慈	uvvy
肥	wcby
笼	qdqp
篮	qnqm
俱	emti
惟	ywii
柜	fgbu
捉	anvo
悬	mvyi
霍	dwiy
泄	ihis
咽	lngd
秒	rmqp
勤	gsxk
屏	busj
霜	dfmf
袍	pwck
蝶	khfv
祭	whsy
胁	wxti
璃	gpxv
赚	kuxt
锦	temv
熙	scuo
寺	hact
昌	jjrr
贺	xlkb
捕	afuo
陵	chte
咳	loiv
扇	ixxi
虹	kfoc
撕	adej
蔡	swhs
彭	dtod
宠	odqp
贪	tovk
誓	aeua
盒	ymne
披	avpo
饶	raqh
跌	nqgu
肌	wqjy
抑	atxj
纹	vpws
宏	osvv
幼	vxko
萍	sihu
驻	xogn
亿	evie
播	aqpj
俄	eqag
挨	avqi
仲	elns
迈	fwpd
辩	ooox
埃	hvqi
艘	qrnb
琪	gdjn
僧	eujj
渡	iusb
卑	wdiu
鼠	rbuj
讯	ovdi
艰	bvnu
斥	eodj
裙	pxql
翠	xxod
饱	rwck
掠	aoma
询	owjr
勃	dyvx
矮	qrcn
瑶	gewo
赐	kjwt
闯	pxmn
姚	cqss
瑟	ggyq
渴	ijwx
昂	jtxj
沟	iwvv
咕	ldgv
驶	xlwl
摄	aabb
贫	tbkb
辕	hhlr
婉	corv
碍	djfa
冠	yfha
魅	wheu
玫	gehn
裁	dgor
坡	hvpt
鸿	ifya
邓	bcju
歪	dfni
乏	qpep
巫	ftte
衫	ptoy
阔	pire
泣	iids
韦	avio
恍	ymhw
贯	bdkb
魄	ewub
柄	ffkt
患	llny
覆	drqe
蜜	oyqk
婴	kkcn
励	sfwx
锅	tlkt
陛	crrh
帕	mebv
咖	lxlv
嫌	cuxt
胳	welv
挖	apvi
啪	laeb
凄	sdxc
眠	mcai
穆	remt
啡	lliv
吾	fclv
坛	hsvv
脾	wwdi
恒	yfjf
屠	bhjr
玻	gvpn
蓉	sptl
耸	ttar
膊	wfac
後	rveh
逆	uxpd
寿	dacn
驱	xgwl
猴	rebq
佣	etne
毅	idqh
舅	rjxk
铜	tkfl
娟	clwy
眯	mpmf
吩	ltbd
匪	glif
牧	wehn
役	rqhc
寄	ogal
诡	oysv
纤	vwks
腐	ueat
姻	cngd
渊	itpm
晰	jfej
骚	xbok
柯	falv
筋	qwxk
崔	jwis
灿	ujso
捷	afxn
淋	iffv
弗	vtig
辑	hlar
廊	uoxc
畏	jgft
歇	jwte
裹	ojfr
苗	sjtj
盼	mtbd
咯	lelv
耍	scnr
煞	yxeu
寝	ouxb
瞒	msft
嫂	crnb
纠	vxgs
慨	yxvq
嚷	losr
驰	xcym
拐	alxk
宴	ojcn
岚	jqwl
浴	ittl
誉	itua
乳	evxi
仓	tvie
逝	aepd
喉	lebq
逛	rgpd
樱	fkkc
哗	lerd
涯	ishh
捧	agao
铭	trlv
障	cijd
摊	abwi
跨	ngfs
妥	ecnk
揉	acqf
晋	aujr
寞	osjg
污	ifsk
嘲	ldjw
吊	lmvv
乾	djqv
伪	eoxo
嗓	lbbf
呈	lgnv
卿	txvv
籍	qdtj
裸	pjfv
链	thpd
灌	islw
畅	kvto
逍	mwpd
帽	mksm
阅	pulq
踩	nefv
窜	plln
哑	laue
趴	ntiv
植	fdmi
媒	cssf
昭	jblv
尹	xqpl
档	fmxl
趟	dnsk
沾	imlv
朴	fmov
瞎	modl
鞭	gefw
俺	egkd
翅	dbxx
肠	wvto
雀	mwia
慎	ydmt
盆	tbmn
迁	wpdk
镖	tdhs
丘	efij
蠢	gjkk
庙	ukou
潘	iqpj
拓	adho
纱	vmqp
漏	ibdy
谨	ogsi
珊	gwwf
仆	emoe
宙	okob
尉	bhac
屑	bmwy
叮	lanv
捂	afcl
涩	ibon
诧	ooqa
柴	nrfv
杆	fhgv
涵	ivkx
坠	ctht
赔	kilv
嘟	lhjc
崩	jwwy
薛	syox
税	rulq
枯	fdgv
译	obao
帘	pmvx
愉	ytfm
骄	xeti
羡	usei
糕	puuo
愚	kyiy
疏	vnoq
堵	hhjr
腕	worv
芸	ssvv
溪	ievg
殷	exvq
鼎	mxtp
稿	rolh
哟	lvwo
冤	yylo
症	pfni
咧	lfrm
湘	ifmf
嫩	cfle
肆	hxao
宰	ooxb
腔	wpfo
哩	lkkv
豹	ywod
鉴	nqwj
绑	vdcj
潇	isxt
桂	fhht
兮	tski
雯	dpwy
颠	dmtk
狮	rufm
契	dbgd
骇	xoim
揭	ajwx
妄	ucnw
坑	hoqj
伐	egge
矩	qgbu
葬	sfrs
诀	obte
鄙	ldnc
柏	febv
躁	nllf
霉	dqbm
侦	emkb
冻	sama
娅	caue
庸	uxwy
筹	qdac
削	mwmd
砰	dhue
耿	auor
牺	wdxn
筒	qkfl
遂	udpd
旭	yjrf
惶	yegn
痒	pugb
竖	nbid
龟	ykdm
斑	gpgn
儒	edsr
嫣	cfnu
宅	oqai
押	akjo
胃	jwyt
旨	rjri
册	wwfi
膝	wftk
浸	ixyb
栏	fusi
衷	onry
艇	qexn
岗	jkwl
赴	dmok
斧	twej
颊	gudk
疆	vhff
炉	uieo
塌	hjxx
乞	qvik
旺	jgnr
烤	uhsk
逊	vmpd
贱	kfgg
辨	ouox
愕	ylls
晌	jrnr
麟	ipra
腥	wjwg
粒	pidm
拟	axot
俏	emwy
杖	fsod
芝	spej
夷	gvgd
衬	pacy
佐	esfo
巷	stck
捡	atfi
桶	fbtn
泼	ixbo
滩	ibwi
琼	goma
昊	jfgd
帆	mqod
搏	afac
颈	bfdk
噢	lrpg
贞	mkbo
凰	qegn
哨	lmwy
拆	aeod
茹	sclv
劣	mqxk
嘱	lbqk
沃	ieos
厢	sfmf
摘	aoud
咋	lqmo
坤	hket
俯	euea
媳	ctyi
嘶	ldej
贡	fkbo
碌	dxkv
拢	adqp
谭	odjd
翁	tvxx
辜	doxg
廉	uuxt
械	fgsj
贸	tkbm
辅	hfuc
呐	lkte
斌	pfgn
填	hdmt
窃	pabd
抄	amqp
溢	iutm
妒	cien
吁	lfau
掀	aeei
芙	sguj
撇	aume
胞	wwck
轿	heti
妨	cogn
拂	avti
衰	ofry
循	redm
挪	avac
蓬	sedp
垃	hidt
账	kthb
驳	xwwl
署	mhjr
顽	fhdk
圾	hvod
枕	fyqr
咦	lgvg
厕	skmd
攀	fwwt
妍	cfsj
拽	akqp
荆	sfsm
妓	cdbu
壶	hykg
於	otsi
寇	ofhb
鹤	ywya
钥	twyj
骤	xabs
渺	immq
刊	hmdg
肢	wdbu
烛	ukco
孕	vvkj
绽	vofn
棉	femv
俘	eevk
盔	sumn
诞	oqnx
兜	etbq
凛	sonh
嚣	lldl
溅	ikfg
笛	qkok
舱	qtvi
鸭	kyaj
噬	lqft
钉	tanj
躬	wvgm
缕	vpcn
咚	lesi
撼	adfy
蕊	syyy
侄	ehke
佑	eslv
雁	sewi
践	nfgg
沐	ifvs
菊	swpm
蜂	kedn
兆	qssi
搅	aiyk
尿	bkvh
黯	nijr
歹	frki
蓄	sovj
朦	wsyd
怯	yhvv
叨	lbdv
纽	vbcs
聘	aksk
腻	wgsk
剥	xkmd
彪	mtou
氓	ucai
榜	fouo
逻	mrpd
壳	hyqj
储	eohj
啤	lwdi
匠	gejf
悍	yjhg
昧	jher
泊	iebs
篷	qedp
狡	rotw
轨	hyfc
汹	iwxg
携	awvj
磊	dddh
隙	cmjm
仑	trie
瞄	msjt
胧	wdqp
趋	dyxl
挠	aaqh
煌	uegn
擅	aonf
卒	ottd
惫	ejyi
瞅	mruo
犬	sqq
砖	dsxo
矣	vqiv
昔	sjrj
裳	nory
骆	xelv
雇	iwie
阎	pyrj
骷	mdgg
鸦	hyay
妞	cbcn
墅	kcht
焚	ffuo
绘	vtsv
梳	fovq
肿	wlns
魁	wsdi
耽	ayqr
擒	atpv
陡	cdkj
璋	gijd
茂	sdwj
蹄	noum
瞥	umtm
瞳	mikk
髅	mpcn
绣	vrvj
硕	ddkb
炒	umqp
邮	kcjo
嫉	cpqi
届	bkoh
嗡	ltvx
娱	clfg
喧	loff
脂	wrjr
膛	wnht
沧	itvi
疚	pyod
扁	ince
搁	apel
茅	scqp
坟	hpwt
掐	ayrj
瑜	gtfm
茵	sngd
苹	shue
旷	juur
蓦	sjgx
诈	oqmo
沫	ihos
菁	shwy
粹	potd
琢	gdod
腊	wsjr
钦	teij
喻	ltfm
宪	owqr
锻	tefq
饥	rqjs
侃	elqr
粘	pmlv
媛	cehb
谊	oomi
恳	vyin
厮	sdej
锤	twsf
聂	abbu
贩	kebu
翩	inxx
呻	lkev
枉	fgnv
拘	awlv
煮	hjuo
址	hnit
匕	rii
渗	ivgt
览	nqkx
敦	oveh
冉	khtf
呃	lsvi
峻	jvte
栽	dgfv
嚎	lods
汁	idis
傍	eouo
禀	onlh
珑	gdqp
邵	blcj
萌	sjwy
窄	pqmo
阮	cfhw
蹈	nerj
碑	dwdi
婶	coke
煤	ussf
寓	okyb
栈	ffgg
滞	isym
倘	ense
杭	foqj
狈	rkbq
峡	jgue
侣	ellv
芦	siej
蔓	sjmb
蒸	svku
禄	hxkv
胀	wthy
淌	inss
伞	tudi
姊	cqxq
钩	twvv
妾	icnd
蜀	mwkc
蝴	kdwy
萝	smrk
弩	cbvg
祷	hdac
稚	rwih
圳	hqct
徽	rfbs
衙	rfca
咸	dflv
陋	cfkx
奢	ghjr
罐	wslw
霄	dmwy
毙	rrfr
敞	nehs
嘘	lmkg
灼	uwod
姗	cwwf
倪	erqr
挫	atth
咪	lpmv
捣	ayjs
燥	ullf
泳	iokv
澈	iove
焕	uykg
酬	giqc
筷	qybt
宵	omwy
揪	aruo
缚	vfac
蚁	kowl
喇	lflm
拎	atob
棠	nfvs
咙	ldqp
哧	lhtt
棺	fobb
璇	goqn
肝	whgy
剂	ptmd
疤	pcbb
渔	iqys
沮	imis
廖	uxxt
皓	ewlv
勋	lkxk
恕	clyi
虐	mxlu
虞	mlfg
综	vohs
瘾	pcyy
驴	xiem
晒	jdxr
卦	hhmo
迦	xlpd
窥	pgkx
堕	cswh
葡	swfu
帖	mmlv
屡	bpcn
蛛	kwti
盲	umfw
碟	dhfv
囚	ntew
揽	anqk
裴	lory
捞	asyx
吏	flwl
铮	tyxv
萄	swwo
盏	fgmn
喔	lbhk
勿	wtoy
蔑	smdo
淹	igkd
麒	idjl
喽	lpcn
栗	dfvx
绷	vwwy
惚	ywty
桓	ffjf
桩	fuht
坊	hogt
履	brqe
璐	gnel
菩	silv
巢	vjfv
畜	ovjt
锡	tjwt
仕	ehfe
芹	sejj
僻	eblo
絮	clbs
浆	urkv
瘫	pbwi
啧	lhkb
磁	duvv
冈	kwlf
逮	xkpd
搓	aufo
胶	wotw
脊	sstw
噩	glll
绰	vmjd
呕	lgwl
嚼	lema
谐	orre
揣	ajsr
殖	frdm
拧	aoan
伺	evfl
霖	dffv
驼	xori
衔	rtah
掷	augc
卸	qfnx
炽	ulti
惭	yhej
框	fggn
捆	anfv
眩	movo
谜	oppd
塘	huxl
阱	csti
亨	ovll
奕	pgdi
蚂	kxmc
猩	rjwg
滨	ioet
沁	iyis
跋	nsbo
藩	siqj
舔	rfgo
捐	alwy
歧	ndbu
隋	csfw
蹭	nujj
甄	dhaw
嗤	lxfk
缸	wfoo
嬉	cdlv
哮	lhvk
熄	utyi
窍	pfsk
俞	tfwm
掘	abxx
屎	bpmh
乍	qmok
弧	vqug
槐	fwuv
铠	tjbj
襟	pffh
梨	rmfv
嗅	ltsq
纲	vkwl
渠	igbf
捅	abtn
扛	afoo
忖	yaci
匈	wwxg
扒	atio
雍	ovqw
霓	drqr
斋	psrw
稽	rdrj
沦	itri
揍	agfg
瞟	mdhs
漪	irgl
暑	jhjr
窟	pbxx
钓	twod
鳞	qpra
瓷	seaw
萱	soff
株	fwti
倭	ercn
鞘	gmwy
绞	votw
睿	myfm
噗	lkug
唔	lfcl
喀	loel
涕	iuvq
拣	aavt
谣	oewo
叽	lqjv
葱	swty
婢	cwdi
铸	tdac
绮	vgal
胤	qvwy
秩	rqgu
畔	juao
粥	vpvg
奎	ghht
绸	vwhl
茨	ssei
熏	wnek
蹬	nbfu
诏	oblv
岔	tbjs
叭	ltiv
咆	lwck
滥	inqm
梧	ffcl
澳	irpg
浙	iaej
甸	wjty
绯	vlis
诛	owti
鲍	qwck
刁	vfii
厥	suxe
蚊	kpwc
鞠	gwpm
茗	srlv
眷	ugmf
戮	xxtg
唬	lmuv
骏	xvte
踹	njsr
漓	ipxv
蝇	klkd
凸	nfnf
酿	govn
蚩	xfkc
唾	lwsf
琐	gmkb
澄	ibfu
猾	rmgq
煎	uwmu
窒	phkx
虾	kakc
蝠	kflj
钞	tmqp
唧	lxvx
觑	mkkx
哽	lfjw
娥	cqag
讪	ojsa
耕	dtst
暧	jeyb
浇	iaqh
嗨	liqb
疫	pqhb
兢	dqdq
箫	qxtt
颅	mbdk
啼	loum
绅	vkes
杉	ftov
嗜	lhrj
券	ugbd
炯	uklv
霎	dicn
迭	qgpd
彷	rogc
觅	ekxk
娴	cpfv
抿	acai
稻	rerj
泻	iysf
怠	vlyi
龚	dqst
绒	vgso
讳	oavi
勺	wody
函	vkxg
颂	tvdk
巍	jrcw
脯	wfuy
镶	tosr
漾	iuok
缴	veoe
藉	sdtj
逞	lgpd
膏	owyl
戳	xxwg
凹	kfif
叩	lxjv
禽	tpxv
懊	yrpg
懈	yytw
蛟	kotw
芊	swkj
慑	yabb
跺	nqfv
跄	ntvi
蚀	rkcs
栖	fdxv
蔚	sbha
铲	tiqp
坪	hhue
筝	qyxv
腮	wjyi
狰	ryxv
踱	nusb
苑	srvi
秉	rxlh
猿	rhlr
佟	eesi
悯	yppw
唠	lsyx
肘	wacy
拇	abmo
霹	dblo
婕	cfxn
禹	qlkk
啃	lnwy
匀	wsiy
怅	ythi
聋	dqar
拯	avkf
忿	tbyi
韧	avbo
邹	yxcj
梢	fmwy
肋	wxky
浦	ifus
炭	jsuo
曦	jurs
簇	qoqq
螺	kjbs
屯	axgi
悴	yotd
匡	ggnf
冀	urjt
倔	ebxx
橙	fbfu
陕	cgue
筱	qene
叱	lriv
矜	cqtv
詹	ystu
芷	snij
惺	yjwg
浊	ikcs
睫	mfxn
睬	mefv
鸽	yyae
吨	laxg
笙	qwgk
戟	djgg
沼	iblv
谍	ohfv
昕	jejr
蛊	kmnc
煜	ujid
祀	hcks
罡	mfni
荫	scwy
酥	grho
懦	ydsr
峨	jqag
轴	hkoc
伽	exlv
捶	awsf
棘	fkfk
嗣	lnvl
钗	tbod
袜	phoy
妩	cfdo
偎	ejgf
窦	pdvg
溶	iptl
膨	wdto
峙	jhac
缉	vlar
徊	rnlv
呗	lkbv
衅	qmua
砂	dmqp
昼	bojf
迸	uspd
斟	dxsd
舆	rhft
靓	hwkx
旬	wjry
窑	pwox
萎	srcn
涟	ihpd
瘩	psye
梵	ffqo
靴	geri
侥	eaqh
兑	ulqr
徘	rlic
芽	shyj
闵	ppwn
嗷	lhwe
芯	syij
澎	idto
邢	fscj
绊	vuao
蜘	kqlv
憎	yujj
靡	plia
褚	phjr
嚓	lowh
珂	galv
崽	jjyi
婵	cujd
悸	yrvk
晦	jqbm
涅	ijht
恬	yrei
渣	ifjf
屉	bhih
缭	vgum
绢	vlwy
袱	pesq
黝	nvxk
茄	sxlv
寅	ofkt
悻	yhud
祟	xxhs
蛙	khht
苇	savi
嵩	jols
茉	shoj
咏	lokv
凿	kudx
粪	psti
噪	lllf
菌	snrh
蝙	kinc
晟	jdvi
禧	hdlv
攒	awqk
旱	jhgr
虔	mpwu
琛	gytf
榴	ftjt
忑	ayik
匣	gkjf
忐	kyis
钝	taxg
廓	uovc
惘	ykuu
漉	iils
蟹	ytbk
曳	kqpd
赎	kdvg
壤	hosr
忡	ylns
冶	svlv
姝	cwti
竿	qhgk
嘈	lsjj
蚕	fgkc
剖	ilmd
颁	tbdk
缀	vbbb
汀	ians
谕	otfm
斐	lpwi
皙	feeb
缪	vxxt
蔷	sdul
恤	yqmn
咄	lxxg
馒	rjmb
矫	qeti
痞	pdlv
橘	fcql
瑾	ggsi
烙	uelv
攘	aosr
汰	igod
溺	ivss
铅	tqlv
咔	lkmo
芭	scbj
戎	gsog
褐	pjwx
吆	lvov
鹃	lwya
帜	mlti
鄂	llfc
蔼	sojx
穗	rgyi
亩	ojtb
绎	vbao
牟	vwnv
咨	selv
奄	gkdd
梓	foxv
绚	vwjr
阀	pegg
烘	usti
惋	yorv
驯	xqcm
墟	hmkg
鬟	hmfr
茬	ssnh
骸	moig
峭	jmwy
缅	vgis
洽	iyes
暄	joff
裔	orkl
砚	dkxh
锥	twij
辙	hove
惦	yuml
铛	tmxl
枣	fksi
桦	ferd
邃	pudp
橱	fsfa
搔	abok
腑	wuea
萤	sykc
枢	fgwl
憬	yjom
庵	ugkd
叼	lvfi
嫖	cdhs
苛	salv
锣	tmrk
蹑	nabb
拌	auao
殴	gwqh
喋	lhfv
糙	pwlp
貂	yblv
葵	sbfg
颐	sdkb
皂	eaib
眈	myqr
扼	asvi
眺	mqss
孜	vehk
玺	ymgo
偌	essl
蹿	npln
弛	vcyg
螂	koxc
趾	nniv
妲	cjfi
掺	avgt
驿	xbao
惬	yggu
抡	atri
憧	yikk
宦	oscb
筐	qggn
瞻	mysu
湃	itfd
俨	eauq
跷	naqh
撅	asue
煽	uixx
呱	lquv
缰	vfjf
衮	otvr
殆	frvl
谴	olkp
蔬	svnq
飒	iqwl
婧	chwy
阐	pujd
荧	syuo
霏	dliy
瘟	pjmn
芜	sfdo
崎	jgal
俐	ermd
屿	jsfi
垄	dqht
畴	jdac
杠	ffov
鬓	hoet
晏	jocn
鞍	gocn
钮	tbcj
珏	ggod
钰	tgod
噔	lbfu
驭	xbum
靶	gcbe
萦	sybs
韬	aver
恙	uyig
竺	qsik
吝	plvw
荀	swjr
癫	pdmk
嘭	ldto
菇	scdg
瘪	pttr
踌	ndac
榕	fptl
昵	jbri
躇	nshj
啰	lmrk
酌	gwod
丙	fkte
涎	iqnx
砌	dabd
鸾	pyai
烨	uerd
噎	lhyu
驹	xwlv
噼	lblo
咎	emlv
亵	oayr
陨	clkb
蠕	kdsr
冕	ksyq
雌	nrwi
茸	sarj
掰	ttbt
蹙	dkmn
橡	fyld
佯	euge
笃	qxmk
崛	jbxx
稼	rods
桀	rafv
拚	avsj
汐	irks
锈	trvj
磅	douo
壕	hods
娄	pcnm
撮	ajab
玑	gqjn
祠	hvfl
黏	rtkl
珀	gebn
睽	mbfg
栓	ftgn
邑	lcbv
瑕	gbsb
磋	dufo
粟	dpmx
薯	smhj
沪	iies
讷	okte
岑	jtov
玮	gavi
迂	fapd
伎	edbu
鲸	qoma
洼	ihht
蹊	nevg
寐	oxhe
肾	nbwy
鸯	kgya
這	upda
涧	ipjr
崆	jpfo
甭	dtnu
笠	qidk
扈	ilcb
哝	lyry
芮	skte
卉	dsji
诬	oftt
札	fxiv
婊	chry
扉	ilie
疮	ptvi
巅	jdmk
坞	hewt
剌	flmd
鳄	qlls
捺	aghs
悼	ymjd
茧	skcj
毋	bsom
曙	jmhj
馅	ryrj
簸	qdvp
妳	cyma
叟	rnbu
拴	atgn
嬷	cpqv
稣	qrhy
痹	pjaj
垣	hfjf
蛤	kyec
蛾	kqag
瑚	gdwy
個	endg
熔	uptl
雏	yxwi
惆	ywhl
拗	avxk
燎	ugum
薰	swne
蕃	sqpj
捋	aeac
籁	qflk
髦	hrma
飓	qwmt
簿	qifa
迢	blpd
汩	ijes
闸	pkjn
狩	roac
蜥	kfej
侨	eeti
劭	blxk
烹	ovuo
咣	lmhw
寰	omfr
紊	pbsw
稠	rwhl
蟆	ksjg
炊	ueio
忻	yeji
炳	ufkt
腆	wkst
酋	ugoe
赃	kuht
拈	amlv
抒	acuo
袄	peoy
褂	phhm
孺	vdsr
胭	wngd
赘	hwek
礁	dwuo
嫡	coud
珉	gcai
钳	tssi
窿	pcew
骋	xksk
嫦	cnmv
槛	fnqm
曜	jxxw
遐	bsbp
蹋	njxx
飕	qwrb
麾	prma
渍	ihkb
猥	rjgf
篝	qskh
枷	fxlv
蜒	kqnx
皎	eotw
霁	dpti
咫	bolt
檬	fsyd
奚	evgd
溯	iuxw
纺	vogs
篱	qpxv
刨	wcmd
忏	ywki
盎	kgmn
戾	isqe
咀	lmiv
屹	jqvi
庚	uxte
隘	cutm
绛	veao
焘	dauo
璨	gmrp
跤	notw
锵	tura
痊	ptgn
嫔	coet
臻	hgrh
泯	icai
糜	ppma
缥	vdhs
褥	psac
魇	sswu
汶	ipws
馋	ryls
渎	idvg
蜿	korv
抠	agwl
棣	fxkv
沓	kjrv
喏	lssl
琶	ggcb
缈	vmmq
缔	voum
酝	gsvv
耷	gard
弼	vdjv
柬	fnue
拷	ahsk
柿	fomv
琵	ggrr
沂	iejs
蕙	sgyi
帛	emvb
柠	foan
饵	rars
撂	ajel
乓	efod
轲	halv
髯	hkht
娉	cksk
圭	hhtt
肪	wogy
瞩	mbqk
啄	ldod
蟑	kijd
炖	uaxg
捎	amwy
嗬	lsel
蘑	spdh
鹊	sjya
矶	dqjh
羌	uxig
骼	melv
筛	qufm
祺	hdjs
馈	rlkk
伫	eofi
羿	xxsj
铎	tbao
啬	dunl
舷	qovo
矗	dmdm
癖	pblo
匾	ginc
瀛	iucn
珞	gelv
毓	qboq
衲	pkte
恺	yjbj
惰	ysfw
诣	orjr
谛	ooum
啷	loxc
佘	thse
黠	nhlv
饲	rvfl
虬	kxic
涤	iefv
骡	xjbs
邯	sscj
笋	qxqp
芥	stti
醺	gwne
舜	eyra
簪	qgqj
蹂	ncqf
恻	ykmd
甥	wjxk
腼	wgiy
驮	xgdm
缤	voet
獠	rgum
锭	tofn
阙	puxe
粤	rpsk
琏	ghpd
椎	fwiv
唆	lvte
煦	jwlu
嵋	jbmf
毡	rmlv
碳	djsu
鸨	rdya
躏	nspw
蜓	kexn
咻	lefv
捍	ajhg
睨	mrqr
娆	caqh
玟	gpwn
徨	regn
嗲	ltwr
粼	prav
谑	omxl
嚏	ldyn
甬	btnu
榨	fpqm
倜	ewhl
稷	rjte
妤	ccun
篡	qmgv
晤	jfcl
肇	iexa
咂	lgmv
帚	xymv
瘤	ptjt
瞠	mnht
嚅	ldsr
怆	ytvi
镔	toet
撵	aggh
裆	pmxl
腺	wekv
骁	xaqh
箐	qhwy
螃	kouo
锢	tndg
晁	jqss
濒	inmk
蝗	kegn
烽	uedn
辘	hilc
莘	soxj
瓮	tvaw
钊	tmdj
篓	qpcn
泓	ivvv
宸	osnb
鞑	ggpd
胄	kwyo
绥	vecn
笺	qfgg
荤	syhc
迄	qvpd
踞	nbdg
慵	yuxw
幌	mjmh
荻	sruo
痪	pykg
骰	mqhg
曝	jjsk
涮	ibmm
踵	nwkk
涣	iykg
俟	evqi
皑	ejbj
瞑	myjt
擞	apce
赂	kelv
麓	ffil
铿	tnbh
峦	pjsi
涓	ilwy
掬	awpm
莓	sqbm
怏	ykgd
萃	sotd
呲	lnri
蹒	nsft
睐	mfpm
昱	jidr
旌	oqwg
摞	ajbs
們	ekne
吠	lsqv
濮	iekg
卞	oakd
琬	gorv
谙	oijr
啕	lwwo
轶	hqgu
陇	cdqp
纨	vyod
霭	dojx
橄	fvae
纶	vtri
垛	hqfv
嗫	labb
盅	lnmn
拄	aogn
踝	njfv
臧	gxsc
岌	jvod
岱	egjs
璞	gkug
缄	vdfl
秧	rkgd
翱	egdx
卤	mnwl
靥	ssgi
逅	eflp
磐	qqdh
斓	ppfu
翊	ixxi
叁	vgfa
阖	phvm
怂	ttyi
汲	ivod
垠	hvnt
迥	klpd
咛	loan
杞	fbjv
痘	pflu
媲	crwr
辄	haxi
恪	yelv
砾	dtma
蜕	kulq
仨	efae
纣	vacs
馁	recn
蜈	klfg
镐	tolj
窈	pvxk
說	utlq
秤	rhue
桢	fmkb
悖	ydyv
涔	ijtv
偕	erre
汴	ioak
桅	fysv
隅	ckyj
琥	gmun
阚	pvae
杵	fqdi
婀	ccal
昙	jsvv
俑	ebtn
侏	ewti
潦	igum
挲	imqt
覃	djdx
硫	dovq
驸	xeac
梆	fdcj
笈	qvod
忱	yyqr
恿	btyi
胥	vnwy
垦	vhtn
窕	pqss
滇	idmt
邬	ecjw
圃	nfuw
咿	lexq
舫	qogo
藐	syeq
逵	hthp
戍	dodw
榭	fwac
牠	wcyn
熹	dluo
蟾	kysu
霾	dykk
蔫	sfnu
跛	nvpv
岐	jdbu
脐	wpti
糗	ptsq
螳	knht
哺	lfuv
鹭	nely
蚣	ktvv
炀	uvto
嵬	jwus
恸	ysvx
隽	wvji
玥	gwyn
籽	pvkm
釜	twhu
磷	dpra
沒	iwbu
谄	oyrj
恣	seyi
溟	iyjt
丕	dfiu
峒	jkfl
芋	sfau
觊	jbkx
旖	oqgl
筵	qqnx
娣	cuvq
涸	indg
颌	ydkb
劾	oxki
趔	dfrm
殇	frqt
噌	lujj
沽	idgs
愫	yhbs
鸢	gyay
玷	gmlv
溥	ifac
疵	pnri
杳	fjrv
聿	xaol
镀	tusb
祎	havi
崴	jdfc
岖	jgwl
雒	elwi
镑	touo
臆	wijy
蜗	klkt
瞰	mvae
郸	ujdc
缆	vnqk
楮	fhjr
诠	otgn
麼	pvoa
犊	wdvg
蟀	kovd
荦	sywn
竣	ivte
骥	xurt
贲	dskb
胴	wkfl
潼	iikk
弑	wfgf
匐	wflj
姣	cotw
蘸	sgwu
渥	ibhk
蛐	kksj
阂	poin
糯	pdsr
嵇	rdjs
谒	ojwx
绾	vobb
舀	erjk
噙	ltpv
槟	foet
嘣	ljww
诃	oalv
脓	wyry
樟	fijd
蛰	ayok
咤	loqa
捱	ashh
阜	ydid
峥	jyxv
濡	idsr
瑙	gvrw
碉	dwhl
荃	stgn
嗵	lbtp
彝	bpbs
臾	rtej
篆	qbds
椭	fcsw
沏	iabd
颦	nmdd
蛆	kmic
淆	iwsw
辎	hvjt
踮	numl
鳅	qruo
會	tfjj
隗	cwuj
渤	idyx
锏	tpjr
遛	tjpd
倌	eobb
氤	qngd
嶙	jpra
馗	yutk
揶	aacj
胚	wdfi
敕	fleh
夙	qfrk
珈	gxlv
锹	truo
迩	ympd
啾	lruo
靼	gjfi
沅	ifhw
馥	rjqe
槌	fypd
為	owwd
褛	ppcn
贻	kvlv
礴	dsia
豚	wdsy
蚱	kqmo
腌	wgkd
耙	dtcb
诽	olia
褴	pnqm
恁	eeyi
呷	lkjv
蚌	kdnc
铝	tllv
憩	rtyi
俾	ewdi
鬃	hohs
祢	hyma
鱿	qdoy
蘅	srqa
唷	lovw
傥	enqr
袈	xlor
豺	yaqp
町	jant
坯	hdfi
戛	dmgg
贮	kofi
剽	dhmd
孬	dcvk
镣	tgum
夥	jfrr
過	npda
匝	gmvf
珩	grah
诘	ohlv
攫	ammb
黔	ntov
臃	wovw
罂	kkwo
酗	gwxg
阪	cebu
冗	yqjm
桧	ftsv
闳	psvv
皿	mnn
囡	ncnw
辍	hbbb
闰	pgnn
煲	elfu
怵	yfod
囤	naxg
蚓	kvns
碴	dfjf
姒	cxot
灸	youo
蚯	kefi
嗥	legd
谗	oyls
箩	qmrk
碱	ddfl
旎	oqbr
谆	oovk
粽	pohs
牒	thfv
泸	imbh
蔺	spwi
刽	tsvm
诋	otao
惇	yovk
缜	vdmt
睑	mtfi
葭	sbsb
妪	cgwl
經	bfvf
噫	lijy
镂	tpcn
癸	bfgd
沣	idns
笆	qcbk
绉	vyxl
抨	ahue
叵	glvf
箕	qdjk
坨	hori
颉	hldk
姹	coqa
赳	dxgk
琮	gohs
焊	ujhg
纭	vsvv
埠	hydi
泱	ikgd
淙	iohs
榛	fgrh
銮	pwji
嗳	leyb
佶	ehlv
犒	woln
饪	rens
砺	dsfw
遽	mdpd
嗟	lufo
钙	tafx
谚	oiqt
馊	rrnb
雉	qwii
虱	vqkc
锴	trre
赈	ksnb
骠	xdhs
跆	nvlv
瘠	pssw
饕	lsmy
佚	eqgu
淄	ivjt
谀	orte
镳	tiuo
廿	sfij
偻	epcn
绺	veml
沱	iori
袤	ocqr
對	kuac
苯	sffi
佻	eqss
繇	ewqb
魈	wmwy
屌	blmv
獗	rsue
鞅	gkgd
蹶	nsue
雹	dwck
旯	jyfr
洱	iars
哂	ldxv
蔗	susu
饨	raxg
奘	xhgd
芍	swod
淞	iftv
腴	wrte
現	gmxn
汾	itbd
顼	gdkb
濂	iuut
麝	iwac
鹞	ewya
蚤	bokc
坂	hebu
忤	yqdi
洙	iwti
祗	htao
迤	qcpd
眦	mnri
暹	jwpd
僮	eikk
钺	tgxi
嘞	lgxk
蛹	kbtn
玳	gegy
睾	qmhd
螭	kpxv
盂	famn
赁	eekb
瑁	gksm
俅	efko
侗	ekfl
骛	cqex
宕	odhb
堰	hgjc
厩	sxvq
鄢	fnsc
帔	mvpv
蓁	sgrh
杈	fbod
挞	agpd
開	kfsj
钏	tqcj
煊	uoff
缮	vuul
夔	utne
燧	uudp
嘁	ldkm
孱	bvvv
懑	isfy
邕	vlcb
柩	fgyo
耆	hrjr
鹄	wlya
龛	ydqp
餮	frty
幄	mbhk
鹘	myag
爰	ehbu
倨	ebdg
汜	icks
诙	osuo
锃	tlgn
璟	gjom
纰	vrri
绡	vmwy
瞭	mgum
鏖	iwjl
氢	qbfo
楔	fdbg
藜	srwk
妫	coxo
栀	fefv
岫	jkos
谥	outm
骧	xosr
犄	wgal
葳	sdfc
辇	gghc
魑	wpxv
椿	fgjr
伢	ehye
谩	ojmb
琊	ghcj
骅	xerd
颍	rkdk
闩	pfin
濠	iods
仞	ebod
玖	gyod
痿	prcn
芑	sbjj
撸	aqjr
檄	feoe
啵	livp
昶	okjr
柚	fkov
祐	hslv
陲	cwsf
亟	vlbf
樽	fuga
舶	qebo
莆	sfuj
蛀	kogn
琨	gjrr
點	nmlv
棂	fxuo
抻	akeo
搽	astf
怩	ybri
嚯	ldwi
韭	lfii
膘	wdhs
酩	grlv
忸	ybci
刎	wtmd
彿	rvti
扪	apno
漳	iijd
瑄	goff
仃	eane
佞	escn
裨	pwdi
巽	ccst
黜	nxxg
滂	iouo
徉	rugc
僖	edlv
纫	vbod
溉	ixvq
範	qgvi
胛	wkjy
卟	lmov
锌	toxj
遑	egpd
跻	npti
珣	gwjr
妗	ctov
蒿	solj
岷	jcai
魃	wsbo
苋	skxj
潞	inel
阕	pbfg
铤	texn
涿	idod
薜	sblo
鲛	qotw
睥	mwdi
滦	ipfv
稔	rtoy
頭	flum
锲	tdbg
徜	rnsc
冼	swqr
獐	rijd
讧	ofoa
氨	qocn
缯	vujj
菀	sorv
炅	juor
碜	dvgt
戗	tvgg
犍	wxax
酊	gano
臌	wddb
钠	tkte
铀	tkoj
羯	ujwx
挝	aapd
邙	ucjw
襁	pvlk
渚	ihjr
胫	wbfo
箸	qhjr
逖	rupd
荟	stsv
汛	ivdi
盥	rkmn
睚	mshh
祚	hqmo
砣	dori
烩	utsv
氣	qpmq
夯	gxkd
驷	xnqr
蜞	kdjc
灏	ijok
發	bvqh
哔	lrrd
擢	axxw
徇	rwjr
荪	svma
蹴	nomd
谯	owuo
忾	yqqi
祛	hhvv
膻	wonf
黢	nvte
仄	steh
唳	lisq
烊	uugo
孀	cdfm
斫	dejh
腚	wofn
牍	tdvg
秣	rhoh
榷	fywi
镭	tdjt
庾	urte
媾	cskh
嫒	ceyb
谌	odxi
啮	lntx
闱	pavi
蝼	kpcn
篙	qolk
膑	woet
問	klvn
隍	cegn
罄	hbqw
蕨	ssue
囵	ntri
橹	fqjr
喱	lskk
話	urea
肓	uwyw
榈	fpll
绶	veyb
罹	mywi
槁	folv
裱	phry
牦	wrmn
荑	sgvg
滓	ioox
腓	wliy
砝	dhvv
嗎	ldmv
秆	rhgh
荏	seen
斛	ytsd
給	byes
恫	ykfl
纾	vcus
麋	ipml
诳	orgn
寮	ogum
驽	cbxm
囫	nwto
炷	uogn
缙	vauj
徕	rfpm
弭	varg
圜	nmfr
撺	apln
儆	eswe
魉	wfkt
妊	cenn
兩	fmrr
矍	mmwb
犸	rxmq
哓	laqh
酶	gqbm
當	njts
缢	vutm
鲫	qxvx
藓	squg
佰	edjr
痔	phac
觥	ytmh
讓	uosr
伉	eoqj
猷	ugsq
怄	ygwl
牯	wdgn
茀	svti
烜	ufjf
轱	hdgc
泵	dkvh
擀	adjh
蝌	krsd
绻	vugv
呔	lgod
纥	vqvi
釉	qpko
翳	gqqx
從	rttn
砧	dmlv
辔	vhvl
胰	wgvg
蜍	ktff
浔	ixac
趿	nvod
鸪	dyag
霰	dswe
邊	tpop
诨	oyhc
僭	egqj
動	wkxk
弁	vsjv
湎	igis
栉	fsxj
蹉	nufo
蓼	sxxt
梏	fwlv
鸩	yqya
虺	hkcw
嘬	ljab
疡	pvto
荞	seti
煨	ujgf
蛔	knlv
焖	upyi
祉	hnis
桎	fhkv
诿	orcn
娠	csnn
瓯	gwaw
偈	ejwx
殚	frud
胱	wmhw
刍	yxlm
糅	pcqf
亞	fjai
岿	juxl
唁	luav
笳	qxlv
齑	ptlf
崂	jsyx
狎	rkjq
踽	nqlk
鳍	qhrj
揆	abfg
钹	tsbo
侩	etsv
帧	mmkb
姮	cfjf
種	rwkk
骈	xusj
仟	ewke
柁	fori
蛭	khkc
珲	gyhc
痍	pgvg
俦	edac
猢	rdwy
镫	tbfu
鼹	rbjc
悌	yuvq
裡	pkky
咩	lugv
亓	faji
铩	twfv
噱	lmds
硌	delv
臉	wrly
脍	wtsv
汞	fkvo
炘	uejo
姘	cusj
泅	inte
铡	tkmd
绦	vefv
桫	fimq
恽	yyhc
薏	sijy
蚪	ksdi
屙	bcal
窸	pqpy
蒺	spqi
觞	ytqt
葺	slar
煅	uefq
茕	syvd
悱	ylii
靛	hwon
拋	adxk
箔	qieb
璠	gqpj
別	lwmd
菅	sobb
嶷	jrqn
臬	tfvk
岬	jkjs
舢	qjso
肱	wsvv
焙	uilv
啖	luuo
蜢	kvmn
級	bvod
铨	ttgn
胺	wocn
旻	jpwr
雲	dsvv
堇	gsie
艽	syfj
湟	iegn
瑭	guxl
踅	aenv
芨	svod
逶	rcpd
嶂	jijd
幾	vvgt
钾	tkjj
跹	nwpd
徭	rewo
鹌	gkya
笞	qvlv
仵	eqdi
缛	vsac
椽	fbds
暝	jyjt
酮	gkfl
玠	gtti
囿	nswy
帏	mavi
畹	jorv
缦	vjmb
铣	twqr
舂	grju
碘	dkst
芫	sfhw
铢	twti
塬	hsem
氯	qxkv
倬	emjd
實	obdm
颏	odkb
缱	vlkp
篾	qmdo
鋆	hwsw
柘	fdhv
猕	rvym
桉	focn
砒	drri
邶	urcj
洌	ifrm
颛	jsdk
蜮	kglf
骢	xrey
柒	iafv
呖	lsxk
饴	rvlv
圩	hfau
茯	sesq
圄	nfcl
琚	gbdg
钿	tjtj
貅	yefv
蛎	ksfw
嫱	cdul
辂	helv
綦	dbsj
笤	qblv
鼬	rbko
苜	smfj
茏	sdqp
艄	qmwy
辚	hpra
撷	ahlk
伥	ethe
骓	xwim
疟	pxlb
筌	qtgn
屐	brdb
猁	rrmd
傩	ebwi
帶	sfym
貊	ydjr
鼐	vmxt
剛	kujm
嗞	luvv
獭	rflk
洮	iqss
獾	rslw
邛	fcjo
赅	koib
擤	atja
咴	lsuo
稗	rwdi
竽	qfau
郾	gjcc
铧	terd
師	yfmv
铆	ttmj
滁	ictf
陂	cvpj
喁	lkyv
湫	iruo
钨	tewj
钲	tfni
噹	lnjt
蕲	suje
舛	raok
荠	spti
玕	ghgn
稞	rjfv
媪	cjmn
笏	qwto
悒	ylcb
晷	jeml
戰	lljg
宥	oswy
摈	aoet
葶	soan
愛	eyye
阡	cwkj
猗	rgal
粕	pebm
蚨	kguc
畲	thjt
睇	muvq
洇	ingd
裏	okry
醮	gwuo
虢	eamu
龍	iwmo
癣	pqug
踯	nugc
內	kruf
珐	ghvv
颎	rudk
馏	rtjt
莛	sexn
髭	hnri
龈	ntxv
楹	fvbm
钯	tcbj
虻	kuwc
苌	sthj
聽	agdy
躅	nmwk
牝	wrin
钎	twkj
畦	jhht
欤	sfei
桁	frah
腩	wdkd
該	uoia
屍	bfrr
蠹	dlyk
眬	mdqp
夢	smyr
張	vhag
瓤	osrq
淝	iwcb
楫	flar
訇	wuay
镊	tabb
镗	tnht
樗	fdfs
苫	smlv
罅	wmqa
涫	iobb
螟	kyjt
骝	xtjt
連	gpdc
蓿	soej
侉	egfs
學	rwwv
厝	ssjr
馐	rubc
潍	ivwi
兕	khwf
黩	ndvg
胪	wmbh
诤	oyxv
抟	asxo
結	bhlv
裝	xhor
芪	stai
莳	sjac
毽	rxax
筇	qfcj
猞	rtre
砭	dqpe
澧	iksu
挈	dbtu
怼	bayi
镞	toqq
貔	yrwr
嬗	conf
搠	auxw
杷	fcbv
薹	shlh
並	ukge
铬	telv
讴	ogwl
闼	pgpd
歃	wrei
輕	gfvf
沆	ioqj
箜	qpfo
彀	hfvg
傳	egac
荩	sbos
雠	wowi
揿	atei
恂	ywjr
茴	snlv
國	nglf
衽	peny
鲈	qmbh
紅	bfos
昴	jtmr
缟	vols
廪	uonh
垓	hoit
奁	ggwl
瘙	pbok
讦	ohga
氖	qvjq
葉	shfv
铰	totw
陉	cbfo
妯	ckon
耄	hrrm
菟	sylo
镛	tuxw
鲧	qqbs
峄	jbao
竦	iflv
飨	vqys
鳏	qmkv
猡	rmrk
痼	pndg
讣	omoa
殺	wfqh
馕	rdlr
枰	fhue
黼	kumf
鲇	qmlv
酽	gauq
歙	yxxe
佤	eawe
妁	cwod
垩	auht
處	meqj
锆	twlv
枇	frri
鄞	gscj
乩	mlxi
場	hjft
垭	haue
萁	sdjj
伧	etvi
盱	mfau
恚	hhyi
鼋	fhlk
钤	ttov
兒	rqrj
轉	ggac
侪	epti
穑	rdul
極	fvlf
煸	uinc
砀	dvto
陣	cgcj
蚋	kkte
吶	lkru
缁	vvjt
颙	kdkb
麂	iqjl
猱	rcqf
跸	nrrd
岈	jhys
掮	aiwy
沔	iaxv
趸	fwnv
苣	sgbu
萸	srte
裢	phpd
捭	awdi
緊	sbbs
雖	lkwi
妣	crri
啁	lwhl
誰	uwia
莴	slkt
缌	vjyi
鹬	cqky
夤	roft
玢	gtbd
終	besi
镏	ttjt
狯	rtsv
焐	ufcl
魆	wgxi
莜	sene
荇	srah
鲠	qfjw
榉	fita
蚝	krmc
楝	ffnu
艨	qsyd
棹	fmjd
睃	mvte
瀣	imrf
骐	xdjm
筢	qacb
靺	ghoe
磔	draf
柞	fqmo
膂	oqrw
鞨	gjwx
锰	tvmn
聃	akht
堞	hhfv
蟥	kskt
薅	scsa
墀	hbkw
窳	pqqu
呎	lbod
怿	ybao
嵯	jufo
艟	qikk
蛳	kufm
迨	vlpd
犰	ryfq
跶	ngpd
橛	fsue
篦	qrwr
趺	nguv
倥	epfo
瞇	mppd
鸹	ryae
崃	jfpm
旒	oqoq
記	ubja
芡	seij
請	uhwy
耧	dtpc
眾	mett
钴	tdgj
欸	vqei
眙	mvlv
耒	dtin
缃	vfmf
怛	yjfi
逄	eapd
哏	lvnv
沤	igwl
荨	sxac
圉	nhud
耋	hrhk
雙	wwbu
毂	hhcf
俳	elie
铱	tory
薮	spce
崤	jwsw
峤	jeti
貘	ysjg
珮	gqfm
笄	qfsj
缗	vcaj
蹁	ninc
秫	rfod
璁	grey
吋	lacv
醪	gxxt
庑	ufdo
郿	bmcj
莼	svax
筮	qftt
挹	alcb
阒	pmsq
媸	cxfk
怫	yvti
鲔	qswy
許	uqdi
疣	pdob
雱	dogy
認	uboy
團	ngac
镍	ttfv
褫	pemu
轳	hmbh
锛	tgds
萬	skyj
鲵	qrqr
熵	uoul
謝	uwac
馑	rgsi
瘆	pvgt
電	dkdy
續	bhmm
塄	hmog
纔	bylo
涞	ifpm
杼	fcuv
沖	ilns
崮	jndg
岘	jkxs
镢	tsue
诂	odga
玦	gbte
鲮	qhte
氟	qvti
洄	inlv
栊	fdqp
孢	vwck
郏	gucj
澶	ionf
詈	muaw
獬	rytw
興	rkft
鳃	qjyi
線	bekv
讵	ogbu
枋	fogv
鞣	gcqf
澌	idej
啭	lhso
蜉	kevk
樘	fnht
耦	dtky
跖	ndhv
虛	mxfi
蛉	ktob
箪	qujd
逋	fpdu
璈	ghwe
扦	awko
孃	cosr
愆	riay
隊	cuds
诔	odti
矇	msyd
鲽	qhfv
狳	rtff
髋	mosk
毖	rryq
槎	fufo
铙	taqh
嫘	cjbs
漯	ijbs
骟	xixx
墒	houl
蹚	nnht
阋	prqr
牖	tifu
刈	wmdl
谝	oinc
悭	ynbh
總	brey
鬲	flkn
瓠	gfsq
麸	hegu
笮	qqmo
圪	hqvi
棰	fwsf
轾	hhkc
衛	rcah
砷	dkeh
杓	fwod
锱	tvjt
餍	ssys
辦	oxox
疴	palv
寤	oxfl
芎	svgj
糍	puvv
捩	aisq
蹼	nkug
鳕	qdxl
缡	vpxv
尻	byfh
茑	syaj
榫	fwdi
幛	mijd
秭	rqxq
鲅	qsbo
郜	wlcj
殍	frev
樨	fbkw
碇	dofn
凼	kxgv
蟮	kuul
炔	ubte
萘	sghs
蓍	shrj
飧	rysk
岢	jalv
刿	jrmd
痧	pimq
蕖	sigf
谰	opfu
霈	difm
訴	ueod
唵	lgkd
叆	sveb
腦	wvrw
钚	tduj
槲	fytd
聖	algn
痈	ptnb
狷	rlwy
酢	gqmo
阍	ptaj
漸	igej
層	bujj
準	iwdi
傈	edfv
怙	ydgi
渌	ixkv
癔	pijy
莪	sqag
視	hmxs
吽	lwnv
腳	wttx
浞	invs
檩	fonh
镠	txxt
嘚	lrja
鸱	taoy
盍	hvmn
昉	jogr
圍	nciw
藥	sevf
赉	fpkb
霪	diee
菏	sial
诹	oabu
夠	rrwl
苴	smij
粳	pfjw
樹	fdac
惡	fjyi
義	uqag
護	uswb
舸	qalv
趵	nwod
笊	qekk
畈	jebu
燠	urpg
阊	pjjr
鸬	mbya
攮	adlr
艿	svjj
璘	gpra
椟	fdvg
氦	qoiq
笸	qglv
圮	hbjt
醛	gstg
佈	esmv
谖	oehb
髡	hhwa
枳	flti
懷	yomr
則	mmdb
髫	hblv
暾	jove
訾	nrua
確	dywi
趕	djhg
镒	tutm
碛	dhkb
缳	vmfr
硖	dgue
溧	idfv
柢	ftao
镬	tswb
皴	vtev
虼	kqvi
軍	ygcm
箝	qass
鋈	iewj
帙	mqgu
锞	tjfv
樓	fldc
泮	iuao
觀	sllm
眭	mhht
溱	igrh
倆	efmr
郯	uucj
隰	cjvu
報	hudb
約	bwod
尋	xfla
朐	wwlv
跬	nhht
愀	yruo
識	uigj
嘡	lnht
毀	rhqh
醚	gppd
鳜	qsue
恆	yfwf
麇	irhl
達	hupd
遄	jspd
竑	isvv
琤	gyxv
趱	dwqk
壞	homr
螅	ktyi
細	bjts
垸	hofh
裎	plgn
埸	hjwt
玭	grri
槠	fohj
顯	jvvm
淚	iisq
肽	wgod
盉	rmnh
顸	hdkb
褊	pinc
鲟	qxac
帻	mhkb
瘐	prte
簋	qvmn
梃	fexn
缵	vwqk
屣	brnn
缒	vypd
塊	hwut
炻	udho
絲	bbss
磴	dbfu
锶	tjyi
跣	nwqr
練	bfnu
迓	hpdy
閃	kten
疖	pxjb
炝	utvi
鐘	wikk
硒	ddxh
啉	lffv
汔	iqvi
伛	egwl
蛄	kdgc
鞯	gssv
绂	vsbo
燹	dduo
翀	xxln
濬	imym
跗	neac
銀	wvnj
凇	sftv
綠	bbkv
調	uwhl
寫	orwu
嗉	lhbs
盡	xfum
饫	reos
辏	hgfg
鼙	ddbd
璩	gmds
沚	inis
純	baxg
殘	frgg
鲥	qjac
褙	purw
煳	udwy
笕	qkxk
尥	dwod
劢	fwxk
隻	wbui
轫	hbod
佾	etwy
抺	aheo
棼	fftb
熘	utjt
萏	syrj
媽	cdmn
睏	mnfv
響	vqoj
喾	iywl
剡	uumd
鍊	wfnu
麴	dewp
曩	josr
砗	dhch
髁	mjfv
蚍	krri
阃	pnfv
溲	irnb
狺	ruaq
鲢	qhpd
傑	eraf
燒	uhhh
缑	vebq
愦	ylkk
疋	vnfi
榧	fgli
蚜	khyc
洫	iqmn
蹾	nove
員	lmbv
粜	xxpm
螈	ksem
踫	nukg
绨	vuvq
抔	aduo
庋	udbu
胝	wtao
計	udia
铍	tvpj
跏	nxlv
锔	tbvl
蝣	koqv
習	xxeb
論	utfn
柙	fkjv
鸫	amya
罘	mduw
潲	irmw
皤	eqpj
笥	qvfl
憶	yijy
險	crlj
鲱	qliy
賣	hmmb
溽	isac
伲	ebri
禮	hksu
痦	pfcl
狀	xsqp
屬	bkmk
嘆	lsfg
桿	fjhg
鳎	qjxx
滏	itwu
廨	uytw
觳	hfyt
戢	lagg
羅	mbwi
郛	evcj
蓐	ssac
買	mmbw
業	kuti
锜	tgal
郇	wjcj
粝	psfw
耜	dtbb
鹩	gujy
厲	ssky
鹪	wuya
髮	hsbo
迴	nlpd
埕	hlgn
坼	heod
洳	iclv
嫠	hesc
尜	mgma
墁	hjmb
廝	udej
埒	heac
脫	wtlq
講	uskh
蔟	soqq
颟	sfkk
劬	wlxk
蹀	nhfv
誘	urvj
飄	dhrf
係	eqbs
谮	ogqj
蠖	kswb
畀	jajt
紛	btbd
蚬	kkxc
镲	towh
郫	wdcj
煩	udmb
讚	uwqm
嗍	luxw
臜	wwqk
阈	pglf
組	bmis
赜	shkb
頂	admb
歲	ndfm
鳐	qewo
陔	coij
狁	rvqr
矽	drkh
擺	amvr
汆	rkvu
呣	lbmv
磲	digf
呒	lfdo
钼	tmfj
蝰	kghh
劁	wumd
肫	waxg
眄	maxv
畋	jeht
崦	jgkd
瘋	prfb
酹	geac
慘	yvvt
髒	msfs
稱	rekh
锑	tuvq
暌	jbfg
蟻	kuqg
菔	swxb
焓	utol
琍	grmd
胙	wqmo
旆	oqfm
靸	gvod
畢	jsao
癒	ptfy
簡	qkjr
觇	mlkx
碡	dhbm
缣	vuxt
擔	aysu
埽	hxym
谠	onqr
丟	gvvn
補	pfuy
聯	avvx
倖	ehud
統	bovq
牆	xhtl
鞬	gxax
芟	sqhj
鲷	qwhl
踔	nmjd
僳	edpm
產	pswg
討	uaca
槭	fdkm
鲞	ugqy
紙	btai
蚴	kvxk
桴	fevk
囟	rwln
費	vtmb
騙	dinc
疃	jikk
燔	uqpj
飑	qwwc
賓	ofmm
琇	grvj
幞	mkug
唑	ltth
溴	itsq
俵	ehry
鲆	qhue
玡	ghyn
掊	ailv
畚	vgjt
鮮	tugy
塵	ihtl
質	eemb
硗	daqh
泖	itms
帥	ymvd
隈	cjgf
劉	twmd
碚	dilv
嵫	juvv
怃	yfdo
側	emmd
罱	mdkd
揮	aygc
捽	aotd
採	aefv
篥	qdfv
設	uqha
虮	kqjc
醢	gslm
陬	cabu
埘	hjac
羑	uyod
翚	xxyh
锕	tcal
櫻	fmmc
負	ymbm
砼	dtfo
課	ujfv
侔	evwn
鏡	wijq
豬	dhjr
偉	ecie
硃	dwti
擋	anjt
牾	wfcl
杪	fmqp
籴	rpmu
缧	vjbs
訝	uhya
鬏	hruo
揠	agjc
畫	xhjf
敗	mehb
蓋	shvm
诼	odod
鹆	ttly
議	uuqg
畎	jsqt
楯	fedm
蛴	kpti
嗌	lutm
詩	uhac
嘌	ldhs
萊	sdlj
缬	vhlk
圖	nldl
賞	nmbs
適	oukp
谇	ootd
驗	drlm
哕	ljrk
罵	mdmw
廛	ukth
丏	axvi
袷	pyey
烃	ubfo
氚	qqcq
黾	lkdv
襻	pfwt
铵	tocn
躞	nuub
緣	bbds
環	gmfr
镉	tfln
涼	ioma
遘	skhp
據	amds
诖	ohht
柽	fbht
绲	vjrr
豨	dwsm
骯	moqj
蹤	nrtn
潔	idbb
禊	hdbg
圬	hfsk
茌	sehf
疔	panb
虿	fwkc
睜	mexv
呋	lguv
圓	nlmb
铯	tycb
慄	ydfv
洧	iswy
垧	hrnt
桕	frjv
跡	npiv
浯	ifcl
橫	fsst
惝	ynsi
蛞	krec
臨	sqll
憐	ypra
牤	wuwn
薷	sdsr
嫋	cvss
獄	rusq
蚵	kalv
爛	ukfu
蕻	shst
蒗	siov
蚰	kkoc
罷	mvwr
鳔	qdhs
焜	ujrr
骶	mtao
圹	huut
霑	diml
徬	rouo
鲀	qaxg
晡	jfur
湔	iuwm
閉	kaqp
聞	karn
歸	ynxm
甾	vjtc
篪	qemu
島	rjso
權	fslw
維	bwis
蘋	snmm
裥	ppjr
紀	bbjs
宮	olrn
紮	fxbs
枵	flsk
笪	qjfi
鲼	qdsk
沩	ioxo
绁	vhis
髌	moet
紡	bogs
罾	mujj
溻	ijxx
蛏	kbht
蜱	kwdi
稜	rhte
莊	sxhf
氆	rukj
餵	yjgf
遙	wwpd
勁	fvfx
優	edwe
樑	fibf
蹟	nhmb
爝	uema
敫	eoeh
爺	twac
钒	tqod
鬆	hftv
踬	nedk
巖	jlle
笾	qxpd
铫	tqss
廢	ubvq
曛	jwne
埝	htoy
楦	foff
钍	thtj
俠	egtt
谂	otoy
際	cwhs
硭	dsuw
茆	stmj
炱	vluo
馇	rfjf
菹	simi
蘭	skfu
趑	dsei
霧	dcqx
屦	brpc
詭	uysv
玙	gsfi
撲	akug
鳊	qinc
軟	geic
棻	stbf
濕	ijvu
螽	eskk
埤	hwdi
蜩	kwhl
莸	srdo
憑	sdyi
鞲	gskh
梿	fhpd
導	utpa
髹	hefv
蓮	sgpd
寧	oyma
毪	rvwn
洎	itks
卣	mnbu
氘	qtiq
栳	fhri
煉	ufnu
骒	xjfv
廳	uagy
災	vuoc
揸	afjf
纏	bukh
織	bigj
籐	qwuk
撐	anhy
渫	ihfv
劼	hlxk
婦	cxym
邾	wtcj
鬍	hdwy
庫	ugcu
縮	boej
堙	hdht
慮	mjyi
紗	bmqp
噍	lwuo
複	pqje
喲	lbwo
寬	osmo
謎	uppd
誤	ulfg
喬	elkl
紋	bpws
鞒	geti
瀰	ivfw
灑	ifki
薑	sfjf
僅	egsi
钋	tmoj
嗪	lgrh
穀	hfrh
刭	bfmd
蛘	kugc
黪	nvgt
遞	empd
攉	adwi
钕	tcnj
氩	qaue
勗	jmxk
損	almb
骀	xvlv
垡	eght
缂	vges
霨	dbha
锇	tqag
肟	wfsk
錄	wbkv
籀	qatj
瘰	pjbs
仡	eqvi
財	maqp
砟	dqmo
牂	xugp
讀	uhmm
傭	euxw
嘗	nrjr
嵛	jtfm
詠	uokv
瓿	ilaw
孫	vqbs
礦	dust
煺	uvpd
瘛	pdby
槔	fegd
垌	hkfl
忭	yoak
鬚	htdm
龐	uiwm
獴	rsyd
蟛	kdto
辋	hkuu
嘧	loyj
龠	ynce
腠	wgfg
儀	euqg
氾	ivis
兇	wxqr
殪	frhu
詞	uvfl
鞴	gsqt
镘	tjmb
穩	refy
唼	licn
捯	ahmd
躍	nxxw
胍	wquy
垚	hhht
烀	uqua
碼	ddmh
檔	fnjt
硐	dkfl
遲	bkwp
壯	xhfp
輩	lgci
箢	qorv
灣	iubv
紹	bblv
檎	ftpv
嘯	lxtf
營	uuyl
戽	isdi
囧	ntkf
苘	sklv
廁	ummd
甏	dtaw
盜	iemn
鳴	lrov
氡	qesi
麵	degi
尷	dsqm
嚄	lswb
瑯	goxc
瘼	psjg
軀	wgll
枧	fkxv
諸	uhjr
桤	fjbj
柺	flxk
積	rhmb
铒	tarj
鑑	wsqm
湲	iehb
鲣	qnbh
帳	mhav
啟	ileh
餓	yqag
痲	psia
坫	hmlv
夬	bteu
閻	kyrj
胂	wkey
贏	umbw
铪	tyej
贶	klqr
肅	xtxf
訚	puan
簽	qrlk
掃	axym
鹇	pfya
疬	psxk
繃	bjww
橋	fell
靿	gvxk
脈	wery
珧	gqss
眵	mrrk
苈	ssxk
钌	tvlj
饹	relv
撥	abvq
籃	qsqm
坭	hbri
賺	muxt
嵝	jpcn
厍	shch
鄹	abec
儘	exfm
躐	nvnb
編	binc
訓	uqca
館	yobb
跐	nnri
砘	daxg
甦	fjww
縱	brtn
綁	bdcj
澤	imhd
埯	hgkd
飲	yeis
堍	hylo
舊	swrj
惱	yvrw
舄	rwuo
姪	chkn
琯	gobb
嬌	cell
暈	jygc
彎	ubbv
硇	drwl
駛	dlwl
爐	umjm
湯	ijft
虧	mwfs
兗	otlq
夼	gqcd
迕	qdpd
鲚	qpti
砜	dqwl
拃	aqmo
圊	nhwy
淠	ijaj
臟	wsgs
違	cpdi
饸	ryes
胨	wama
拤	akmo
禍	hnas
菪	sodh
輛	gfmr
箦	qhkb
彌	vftw
腈	whwy
滗	iqrm
奧	rqpg
溝	iskh
仉	eqje
镧	tpfu
犏	winc
縠	hfbs
詛	umia
駕	xldm
絶	bycb
綑	bnfv
齉	tjar
罈	wdjd
鋒	wedn
獲	rswb
暢	kjft
钫	togj
侶	elrn
坌	tbht
潛	igqj
梱	fnfv
頹	rqdm
臺	hlyh
褟	pjxx
監	sqmn
悅	ytlq
铋	tyqp
辭	ebko
縫	bedp
胬	cbkt
濤	ihva
潰	ilkm
勳	wnxk
繫	gxqb
澉	ivae
齋	ounh
肼	wsti
廂	ufmf
簷	qysu
鼯	rbfl
闖	kdmn
窮	pwvg
棁	fulq
枨	fthv
鹛	bmya
鍾	wwkk
捃	axql
燜	ukyi
罨	mgkd
恓	ydxi
訊	uvdi
蒟	siwl
酤	gdgo
療	pgum
俬	ervv
罰	mumd
跞	ntma
媭	tdkc
罽	msum
绗	vrah
閑	kfvn
闊	kire
蛸	kmwy
廟	udjw
韁	gfjf
杻	fbcv
撿	arlo
崚	jhte
蔭	sctv
眍	mgwl
搋	aemu
緻	bheh
綿	bemv
渾	iygc
芼	srmj
墳	hdsm
嚕	ltjr
兌	tlqr
脅	xxxw
蠅	kjmc
泐	icxk
賜	mjwt
魯	tjry
荬	svsg
眊	mrmf
瘵	pwhs
鎮	wdmt
騷	dbok
挾	agtt
檢	frlv
運	ygpd
揹	aurw
嬝	cror
窺	pgmx
迮	qmpd
鶉	ovro
飽	ywck
跼	nbvl
鵝	qagr
瑪	gdmn
驅	dgll
踺	nxax
窩	pnax
炤	ublv
嗚	lywv
賀	xlmb
竄	prbu
脣	swyn
譜	uukj
詢	uwjr
殼	hfqj
錶	whry
繩	bjms
攤	asfw
鰭	thrj
誅	uwti
併	eusj
赇	kfko
儲	euhj
睪	mhud
築	qfqf
閱	ktlq
頁	dmbh
慶	ivye
龜	qjmp
鬱	fwft
楓	frfv
摟	aldc
評	uhue
糾	bxgs
鱗	tpra
馳	dcym
爍	uevf
镓	tods
納	bkte
謔	umxl
賦	mfgn
縛	bfac
蝕	ykcs
黨	nnes
攴	mbuo
週	whlp
燻	uwne
鳢	qksu
鳙	quxw
饒	yhhh
菴	sgkd
螵	kdhs
嶽	jrus
鍋	wnaj
壇	honf
闢	kblo
稅	rtlq
諷	urfa
償	enmb
億	eijy
噓	lmxf
鋼	wkuj
曬	jfki
誇	ugfs
籤	qttf
呂	lrnv
闔	khvm
狹	rgtt
飼	yvfl
購	mskh
誕	uqnx
嘖	lhmb
鏈	wgpd
潑	ibvq
侷	ebvl
郵	wsfc
絡	belv
擬	arqn
疊	jjjm
蔣	sxwa
骣	xbvv
輔	gfuc
審	oqpj
筍	qwjr
邁	skpd
犋	wmti
蘇	strh
軌	gyfc
彙	byjf
搗	arjs
鴦	kgro
篛	qvss
耠	dtye
嚆	lsol
賊	mgso
鳓	qgxk
萜	smml
朧	wiwm
艙	qtol
洶	iwwx
穌	trhy
賢	sbmb
巘	jmfs
蔥	srey
譽	rsku
滄	itol
闋	kbfg
鑰	wync
蒐	swuj
轅	ghlr
柈	fuao
曠	just
鹹	kdfl
慍	yntm
渦	inas
窪	pihh
債	ehmb
漲	ivha
覷	mkmx
纖	bttf
祙	hhes
粞	pdxm
矓	miwm
駭	doim
噠	lhup
綱	bkuj
韻	ijlm
膦	wpra
懇	yvyi
铟	tngd
寵	oiwm
嚨	liwm
襯	pifm
燦	umrp
縣	mmqb
擴	aust
獰	roya
嬤	cpvo
漁	itys
醃	ggkd
鈕	wbcj
篤	qdmk
攔	akfu
挦	axac
狽	rmbq
铌	tbri
瓏	giwm
僱	eiwi
屜	brhi
辮	obox
絨	bgso
餅	yusj
屆	bhxg
釀	gosr
莖	sfvf
蘿	smbw
簑	qofr
镩	tpln
揳	adbg
葦	scij
茓	spxj
賠	milv
衆	qmes
燼	uxfm
嵎	jkys
譯	umhd
弔	vnsg
釘	wanj
愜	yggt
錘	wwsf
枴	flbd
嵖	jfjf
瑋	gcin
猙	rexv
蝽	kgjr
籠	qiwm
縷	bldc
铼	tfpm
牁	xalv
姦	cccn
犧	wurs
蘊	sbnm
蠶	gqgk
滪	icdk
嵐	jrfs
輟	gbbb
磚	dgac
紈	byod
鴉	hroy
淵	itxf
釣	wwod
譎	ucql
禪	hlld
綵	befv
樸	fkug
穢	rndm
脹	whay
槓	ffmb
鼢	rbtb
韓	djci
盃	dmnu
蝦	kbsb
綢	bwhl
塆	hpvg
囑	lbkk
壺	hyja
詐	uqmo
燐	upra
膠	wxxt
趨	dwxx
梟	rfvo
悵	yhai
鍛	wefq
絞	botw
攙	aylo
錐	wwij
僕	ekug
絆	buao
諧	urre
齪	mnvc
釵	wbod
攪	arwm
崗	jkuj
膙	wvlk
瑣	gmmb
盞	ggmn
齬	mfcl
嘔	lgll
鵬	wwro
緬	bgis
醬	xwag
緝	blar
繚	bgum
贖	mhmm
繽	bofm
潟	irwu
欽	weij
曇	jdsv
鞡	gaid
镵	tylo
脒	wpmy
廚	udac
鴨	kroj
氳	qntm
鐺	wnjt
鹐	yrya
颯	irfd
誼	uomi
娛	clxg
峽	jgtt
妝	xcnp
髏	mldc
輯	glar
淺	iggg
薦	sisu
姍	cncn
覓	emxk
喫	ldbg
稃	revk
遷	dgcp
躪	nskw
鞦	gruo
鏟	wiqw
矚	mbkk
喹	lghh
缽	wffi
綣	bugv
齣	mwlv
貢	fmbo
綺	bgal
鶴	ywro
靂	dsrn
畝	ojyo
馴	dqcm
媼	cntm
漣	igpd
芻	wxwx
憫	ykpw
箇	qndg
繡	bxtf
蘆	smjm
揀	afnu
綽	bmjd
颳	rref
卹	qmxj
壎	hwne
餚	ywsw
繪	btfj
幀	mmmb
燭	umwk
闌	kfnu
絢	bwjr
椪	fukg
鬨	nsti
靄	dujx
廠	uneh
絹	blwy
铷	tclv
鹽	sqkm
瓊	gyke
綜	bohs
隕	clmb
譴	ulkp
紐	bbcs
錦	wemv
囁	laaa
牀	xfvp
繭	sknk
瀝	isrn
馱	dgdm
鑲	wosr
噥	lkss
澱	ibsq
隸	fhxk
虜	mjxk
懺	yttf
踐	nggg
籌	qhva
摳	agll
頃	rdmb
櫂	fxxw
搾	apqm
嶼	jrst
螋	krnb
諏	uabu
裊	rory
陝	cgrr
欖	fsqm
襪	psmo
糰	pnga
驃	ddhs
韌	cbod
鉅	wgbu
铈	tomv
紳	bkes
睞	mdlf
駟	dnqr
鵑	lwro
褻	ohtr
匜	gcyf
齶	mlls
瀆	ihmm
慚	ygej
滌	ienf
腎	sbwy
縊	butm
柵	fncv
澗	ikjr
鴿	yroe
詰	uhlv
僞	eeww
諱	ucia
銜	rwah
誠	udvi
鋸	wbdg
覬	jflm
暘	jjft
貿	tmbm
蠔	kods
謅	uwxx
斕	pkfu
躱	wvfv
誥	uwlv
竇	phmm
藪	slde
輿	rgft
閘	kkjn
鴛	rvro
輻	gflj
鉗	wssi
鏤	wldc
纴	vens
螻	kldc
驢	dmjm
驛	dmhd
儂	ekss
輓	gylq
繾	blkp
繳	beoe
緘	bdfl
絝	bgfs
礫	devf
滷	ikls
駑	cbdm
軔	gbod
縐	bwxx
覈	deoe
擰	aoya
聶	aaar
僑	eell
繹	bmhd
緯	bcis
攬	asqm
皚	ejfu
餌	yars
軸	gkoc
鸚	mmcr
濘	ioya
嶄	jgej
誨	uqbm
誒	uvqi
讖	uttf
朶	vfvj
訐	uhga
餉	yrns
嚶	lmmc
貲	nrmb
賄	mswy
襠	pnjt
癘	psky
篩	qyfm
鍬	wruo
鋤	wmxk
莢	sgtt
憲	odmy
臚	wmjm
鉛	wqlv
鑣	wiuo
犢	whmm
轡	bgbl
儉	erle
櫥	fuda
鷂	ewro
貳	gsmb
韜	cerj
卽	erxj
匱	glkm
殯	from
檸	foya
摑	angf
磯	dvvt
賁	dsmb
濾	imjy
貸	egmb
贓	mgxs
囌	lstr
龕	yiwm
囈	lshv
饅	yjmb
銻	wuvq
誣	uftt
鴆	yqro
幟	migj
餡	yyrj
齟	mmic
魷	tdoy
輒	gaxi
轂	hfgc
嬪	cofm
嶇	jgll
闕	kuxe
崟	jwjs
訃	umoa
囀	lgga
詫	uoqa
鳶	groy
鈉	wkte
矯	qell
嫻	ckfv
馮	sdmi
籲	qynm
蓽	sjsa
踴	nbtx
萵	snaj
嬈	chhh
踒	nrcn
紉	bbod
儔	ehva
綾	bhte
繮	bfjf
櫝	fhmm
醞	gntm
緇	bvjt
鴣	drog
奩	ggll
紼	bvti
綰	bobb
韃	ghup
琺	gihv
歿	frwb
縟	bsac
廡	uqsu
詼	usuo
闈	kcin
嶗	juux
甽	jqct
鉻	welv
閏	kgnn
諍	uyxv
鹼	krll
蝸	knac
襖	prpg
颶	rmti
玅	ovmq
跥	nvfv
圇	ntfn
藺	skwi
鸻	raya
簫	qxtf
幗	mngf
铻	tfcl
葷	sygc
賑	msnb
躥	nprb
躊	nhva
蘚	stug
齦	mvnc
鑠	wevf
壙	hust
騾	djbs
餾	ytjt
疇	jhva
鈾	wkoj
鎢	wywj
錚	wyxv
懍	yonr
愾	yqpm
鍍	wusb
驪	dfki
櫛	fqxx
䦃	tshj
讒	uylo
詮	utgn
謨	usjg
訖	uqvi
諺	uiqt
詁	udga
䥽	txbo
鱸	tmjm
襤	psqm
牘	thmm
鰱	tgpd
鱷	tgll
蓀	svqb
蕪	sqsu
稈	rjhg
鼴	rbgc
簍	qldc
鈣	wafx
鉑	webj
鐃	whhh
鏍	wjbs
愴	ytol
飭	yqxk
奐	yktg
飪	yens
餒	yecn
飩	yaxg
銖	wwti
錳	wvmn
銓	wtgn
鎳	wtfv
䏝	wsxo
鑊	wswb
鈽	wsmv
釧	wqcj
鋅	woxj
鏃	woqq
鏝	wjmb
糉	pwxe
褸	pldc
墾	yvht
縑	buxt
倀	ehae
驥	durt
硯	dmxh
駙	deac
嬋	clld
隴	ciwm
嫗	cgll
綞	bwsf
纜	bsqm
齲	mqlk
紇	bqvi
締	boum
縲	bjbs
綏	becn
鷥	bbro
紂	bacs
捫	akno
㧟	aigf
傯	erey
曁	ergf
傖	etol
貯	moan
螄	kyfm
蟈	kngf
閆	kfan
崢	jexv
塢	hywt
壢	hsrn
琿	gygc
軋	gxic
輜	gvjt
鵪	gkro
轆	gilc
輊	ghkc
軾	ggfo
璦	geye
櫚	fkll
饈	yubc
㤘	yyxl
